Lua Dissection	Lua Dissection	_ws.lua
Expert Info	Expert	_ws.expert
CBOR Item Decoder	CBOR Item Decoder	_ws.wscbor
29West Protocol	29West	29west
Pro-MPEG Code of Practice #3 release 2 FEC Protocol	2dparityfec	2dparityfec
3Com XNS Encapsulation	3COMXNS	3comxns
3GPP COMMON	3GPP COMMON	3gpp
3GPP2 A11	3GPP2 A11	a11
5G Lawful Interception	5GLI	5gli
IPv6 over Low power Wireless Personal Area Networks	6LoWPAN	6lowpan
802.11 radio information	802.11 Radio	wlan_radio
IEEE 802.11 Radiotap Capture header	802.11 Radiotap	radiotap
IEEE 802.11 RSNA EAPOL key	802.11 RSNA EAPOL	wlan_rsna_eapol
Slow Protocols	802.3 Slow protocols	slow
Plan 9	9P	9p
GSM A-bis OML	A-bis OML	gsm_abis_oml
A21 Protocol	A21	a21
Arinc 615a Protocol	A615a	a615a
AVTP Audio Format	AAF	aaf
ATM AAL1	AAL1	aal1
ATM AAL3/4	AAL3/4	aal3_4
Appletalk Address Resolution Protocol	AARP	aarp
Aastra Signalling Protocol	AASP	aasp
AUDIOCODES DEBUG RECORDING	AC DR	acdr
Application Configuration Access Protocol	ACAP	acap
MIPv6 Option - Access Network Identifier	Access Network Identifier	mip6.options.acc_net_id
Access Point Name	Access Point Name	vsncp.opt.apname
MIPv6 Option - Access Technology Type Option	Access Technology Type Option	mip6.options.att
ACF Message	ACF	acf
Architecture for Control Networks	ACN	acn
ACP133 Attribute Syntaxes	ACP133	acp133
Advanced Card Systems ACR122	ACR 122	acr122
ISO 8650-1 OSI Association Control Service	ACSE	acse
AudioCodes Trunk Trace	ACtrace	actrace
Android Debug Bridge	ADB	adb
Android Debug Bridge Client-Server	ADB CS	adb_cs
Android Debug Bridge Service	ADB Service	adb_service
DSRC Addition Grp C (EU)	ADDGRPC	dsrc.addgrpc
Address Allocation Cause	Address Allocation Cause	vsncp.opt.addressalloc
Address and Control Field Compression	Address and Control Field Compression	lcp.opt.addr_field_compress
Aruba Discovery Protocol	ADP	adp
ADwin communication protocol	ADwin	adwin
ADwin configuration protocol	ADwin-Config	adwin_config
Aeron Protocol	Aeron	aeron
Apple Filing Protocol	AFP	afp
Andrew File System (AFS)	AFS (RX)	afs
AgentX	AgentX	agentx
Authentication Header	AH	ah
AOL Instant Messenger	AIM	aim
AIM Administrative	AIM Administration	aim_admin
AIM Advertisements	AIM Advertisements	aim_adverts
AIM Privacy Management Service	AIM BOS	aim_bos
AIM Buddylist Service	AIM Buddylist	aim_buddylist
AIM Chat Service	AIM Chat	aim_chat
AIM Chat Navigation	AIM ChatNav	aim_chatnav
AIM Directory Search	AIM Directory	aim_dir
AIM E-mail	AIM Email	aim_email
AIM Generic Service	AIM Generic	aim_generic
AIM ICQ	AIM ICQ	aim_icq
AIM Invitation Service	AIM Invitation	aim_invitation
AIM Location	AIM Location	aim_location
AIM Messaging	AIM Messaging	aim_messaging
AIM Popup	AIM Popup	aim_popup
AIM Signon	AIM Signon	aim_signon
AIM Server Side Info	AIM SSI	aim_ssi
AIM Server Side Themes	AIM SST	aim_sst
AIM Statistics	AIM Stats	aim_stats
AIM Translate	AIM Translate	aim_translate
AIM User Lookup	AIM User Lookup	aim_lookup
Advanced Intelligent Network	AIN	ain
Apache JServ Protocol v1.3	AJP13	ajp13
Asynchronous Layered Coding	ALC	alc
AAL type 2 signalling protocol (Q.2630)	ALCAP	alcap
Align-NPDU	Align-NPDU	osinlcp.opt.def_pid
AllJoyn Message Protocol	AllJoyn	aj
AllJoyn Reliable Datagram Protocol	AllJoyn ARDP	ardp
AllJoyn Name Service Protocol	AllJoyn NS	ajns
AltBeacon	AltBeacon	alt_beacon
MIPv6 Option - Alternate Care-of Address	Alternate Care-of Address	mip6.options.acoa
MIPv6 Option - Alternate IPv4	Alternate IPv4	mip6.options.alt_ip4
Action Message Format	AMF	amf
AMP	AMP	amp
Advanced Message Queueing Protocol	AMQP	amqp
Adaptive Multi-Rate	AMR	amr
Adaptive Multi-Rate WB	AMR WB	amr_wb
AMS	AMS	ams
Automatic Multicast Tunneling	AMT	amt
Access Node Control Protocol	ANCP	ancp
Intel ANS probe	ANS	ans
ANSI A-I/F BSMAP	ANSI BSMAP	ansi_a_bsmap
ANSI A-I/F DTAP	ANSI DTAP	ansi_a_dtap
ANSI IS-637-A (SMS) Teleservice Layer	ANSI IS-637-A Teleservice	ansi_637_tele
ANSI IS-637-A (SMS) Transport Layer	ANSI IS-637-A Transport	ansi_637_trans
ANSI IS-683 (OTA (Mobile))	ANSI IS-683 (OTA (Mobile))	ansi_683
ANSI IS-801 (Location Services (PLD))	ANSI IS-801 (Location Services (PLD))	ansi_801
ANSI Mobile Application Part	ANSI MAP	ansi_map
ANSI Transaction Capabilities Application Part	ANSI_TCAP	ansi_tcap
Ad hoc On-demand Distance Vector Routing Protocol	AODV	aodv
ATAoverEthernet	AOE	aoe
America Online	AOL	aol
APN Aggregate Maximum Bit Rate(APN-AMBR)	APN Aggregate Maximum Bit Rate(APN-AMBR)	vsncp.opt.apn_ambr
Apple Network-MIDI Session Protocol	AppleMIDI	applemidi
Automatic Position Reporting System	APRS	aprs
aptX Codec	aptX	aptx
AR Drone Packet	AR Drone	ar_drone
ARCNET	ARCNET	arcnet
The Armagetron Advanced OpenGL Tron clone	Armagetronad	armagetronad
Address Resolution Protocol	ARP/RARP	arp
Artemis Core Protocol	Artemis	artemis
Art-Net	ARTNET	artnet
Aruba Networks encapsulated remote mirroring - AIRMAGNET (Type 2)	ARUBA ERM AIRMAGNET (Type 2)	aruba_erm_type2
Aruba Networks encapsulated remote mirroring - PCAP (Type 0)	ARUBA ERM PCAP (Type 0)	aruba_erm_type0
Aruba Networks encapsulated remote mirroring - PCAP+RADIO (Type 3)	ARUBA ERM PCAP+RADIO (Type 3)	aruba_erm_type3
Aruba Networks encapsulated remote mirroring - PEEK (Type 1)	ARUBA ERM PEEK (type 1)	aruba_erm_type1
Aruba Networks encapsulated remote mirroring - PEEK (Type 5)	ARUBA ERM PEEK-NG (type 5)	aruba_erm_type5
Aruba Networks encapsulated remote mirroring - PPI (Type 4)	ARUBA ERM PPI (Type 4)	aruba_erm_type4
Aruba Networks encapsulated remote mirroring - RADIOTAP (Type 6)	ARUBA ERM RADIOTAP (type 6)	aruba_erm_type6
Aruba Networks encapsulated remote mirroring	ARUBA_ERM	aruba_erm
Aruba Instant AP Protocol	aruba_iap	aruba_iap
Aggregate Server Access Protocol	ASAP	asap
Alert Standard Forum	ASF	asf
AppleTalk Session Protocol	ASP	asp
Asphodel	Asphodel	asphodel
ASTERIX packet	ASTERIX	asterix
Async Control Character Map	Async Control Character Map	lcp.opt.asyncmap_bytes
AT Command	AT	at
Apache Tribes Heartbeat Protocol	ATH	ath
Asynchronous Transfer Mode	ATM	atm
ATM Cell	ATM Cell	mplspwatmcell
ATM LAN Emulation	ATM LANE	lane
ATM Address Resolution Protocol	ATMARP	atmarp
ATM over TCP	ATMTCP	atmtcp
ICAO Doc9705 CM	ATN-CM	atn-cm
ICAO Doc9705 CPDLC	ATN-CPDLC	atn-cpdlc
ICAO Doc9705 ULCS	ATN-ULCS	atn-ulcs
AppleTalk Transaction Protocol packet	ATP	atp
Microsoft AT-Scheduler Service	ATSVC	atsvc
Attach Type	Attach Type	vsncp.opt.attachtype
MIPv6 Option - AUTH-OPTION-TYPE	AUTH-OPTION-TYPE	mip6.options.auth
Authentication Option	Authentication Option	lcp.opt.auth
Authentication Protocol	Authentication Protocol	lcp.opt.auth_protocol_bytes
MIPv6 Option - Authorization Data	Authorization Data	mip6.options.bad_auth
Cisco Auto-RP	Auto-RP	auto_rp
AUTOSAR Network Management	AUTOSAR NM	autosar-nm
AVS WLAN Capture header	AVS WLANCAP	wlancap
Arista Vendor Specific Protocol	avsp	avsp
Apple Wireless Direct Link action frame	AWDL	awdl
Apple Wireless Direct Link data frame	AWDL data	awdl_data
Amateur Radio AX.25	AX.25	ax25
AX.25 KISS	AX.25 KISS	ax25_kiss
AX.25 no Layer 3	AX.25 no L3	ax25_nol3
AX/4000 Test Block	AX4000	ax4000
Anything in Anything Protocol	AYIYA	ayiya
Babel Routing Protocol	Babel	babel
Building Automation and Control Network APDU	BACapp	bacapp
Building Automation and Control Network NPDU	BACnet	bacnet
BACnet MS/TP	BACnet MS/TP	mstp
Twisted Banana	Banana	banana
Logical-Link Control Basic Format XID	Basic Format XID	basicxid
B.A.T.M.A.N. Layer 3 Protocol	BAT	bat
B.A.T.M.A.N. GW	BAT GW	bat.gw
B.A.T.M.A.N. Vis	BAT VIS	bat.vis
B.A.T.M.A.N. Advanced Protocol	BATADV	batadv
Bazaar Smart Protocol	Bazaar	bzr
Black Box Log	BBLog	bblog
BCTP Q.1990	BCTP	bctp
Blocks Extensible Exchange Protocol	BEEP	beep
Bencode	Bencode	bencode
Basic Encoding Rules (ASN.1 X.690)	BER	ber
Binary Floor Control Protocol	BFCP	bfcp
Bidirectional Forwarding Detection Control Message	BFD Control	bfd
Bidirectional Forwarding Detection Echo Packet	BFD Echo	bfd_echo
Border Gateway Protocol	BGP	bgp
Bearer Independent Call Control	BICC	bicc
3GPP BICC MST	BICC-MST	bicc_mst
MIPv6 Option - Binding Authorization Data for FMIPv6 (BADF)	Binding Authorization Data for FMIPv6 (BADF)	mip6.options.badff
MIPv6 Option - Binding Identifier	Binding Identifier	mip6.options.bi
MIPv6 Option - Binding Refresh Advice	Binding Refresh Advice	mip6.options.bra
Bitcoin protocol	Bitcoin	bitcoin
BitTorrent	BitTorrent	bittorrent
Canon BJNP	BJNP	bjnp
BLIP Couchbase Mobile	BLIP	blip
bluecom Protocol	bluecom	bluecom
Bluetooth	Bluetooth	bluetooth
Broadcast/Multicast Control	BMC	bmc
BGP Monitoring Protocol	BMP	bmp
Boardwalk	Boardwalk	brdwlk
Wellfleet Breath of Life	BOFL	bofl
Boot Parameters	BOOTPARAMS	bootparams
DCE DFS Basic Overseer Server	BOSSVR	bossvr
Bundle Protocol	BP	bundle
Amateur Radio BPQ	BPQ	bpq
DTN Bundle Protocol Security	BPSec	bpsec
DTN Bundle Protocol Version 7	BPv7	bpv7
BPv7 Administrative Record	BPv7 Admin	bpv7.admin_rec
Bridge Control Packet Indicator	Bridge Control Packet Indicator	bcp_ncp.opt.bcp_ind
Bridge-Identification	Bridge-Identification	bcp_ncp.opt.bridge_id
Broadcom tag protocol	Broadcom tag	brcm-tag
Microsoft Windows Browser Protocol	BROWSER	browser
BRP Protocol	BRP	brp
BACnet Secure Connect Virtual Link Control	BSCVLC	bscvlc
BSD LZW Compress	BSD LZW Compress	ccp.opt.bsdcomp
BSSAP/BSAP	BSSAP	bssap
BSSAP2	BSSAP2	bssap_plus
Base Station Subsystem GPRS Protocol	BSSGP	bssgp
BSS LCS Assistance Protocol	BSSLAP	bsslap
Bluetooth 3DS Profile	BT 3DS	bt3ds
Bluetooth A2DP Profile	BT A2DP	bta2dp
Bluetooth A2DP Content Protection Header SCMS-T	BT A2DP Content Protection Header SCMS-T	bta2dp_content_protection_header_scms_t
Bluetooth AMP Packet	BT AMP	btamp
Bluetooth Attribute Protocol	BT ATT	btatt
Bluetooth AVCTP Protocol	BT AVCTP	btavctp
Bluetooth AVDTP Protocol	BT AVDTP	btavdtp
Bluetooth AVRCP Profile	BT AVRCP	btavrcp
Bluetooth OBEX BIP Application Parameters	BT BIP Application Parameters	obex.parameter.bt.bip
Bluetooth BNEP Protocol	BT BNEP	btbnep
Bluetooth OBEX BPP Application Parameters	BT BPP Application Parameters	obex.parameter.bt.bpp
Bluetooth BR/EDR FHS	BT BR/EDR FHS	btbredr_fhs
Bluetooth Pseudoheader for BR/EDR	BT BR/EDR RF	btbredr_rf
Bluetooth Common	BT Common	btcommon
Bluetooth OBEX CTN Application Parameters	BT CTN Application Parameters	obex.parameter.bt.ctn
Bluetooth DUN Packet	BT DUN	btdun
Bluetooth GATT Attribute Protocol	BT GATT	btgatt
Bluetooth GATT Attribute Aerobic Heart Rate Lower Limit (UUID 0x2a7e)	BT GATT Aerobic Heart Rate Lower Limit (UUID 0x2a7e)	btgatt.uuid0x2a7e
Bluetooth GATT Attribute Aerobic Heart Rate Upper Limit (UUID 0x2a84)	BT GATT Aerobic Heart Rate Upper Limit (UUID 0x2a84)	btgatt.uuid0x2a84
Bluetooth GATT Attribute Aerobic Threshold (UUID 0x2a7f)	BT GATT Aerobic Threshold (UUID 0x2a7f)	btgatt.uuid0x2a7f
Bluetooth GATT Attribute Age (UUID 0x2a80)	BT GATT Age (UUID 0x2a80)	btgatt.uuid0x2a80
Bluetooth GATT Attribute Aggregate (UUID 0x2a5a)	BT GATT Aggregate (UUID 0x2a5a)	btgatt.uuid0x2a5a
Bluetooth GATT Attribute AirFuel Alliance - Wireless Power Transfer (WPT) Service (UUID 0xfffc)	BT GATT AirFuel Alliance - Wireless Power Transfer (WPT) Service (UUID 0xfffc)	btgatt.uuid0xfffc
Bluetooth GATT Attribute Alert Category ID (UUID 0x2a43)	BT GATT Alert Category ID (UUID 0x2a43)	btgatt.uuid0x2a43
Bluetooth GATT Attribute Alert Category ID Bit Mask (UUID 0x2a42)	BT GATT Alert Category ID Bit Mask (UUID 0x2a42)	btgatt.uuid0x2a42
Bluetooth GATT Attribute Alert Level (UUID 0x2a06)	BT GATT Alert Level (UUID 0x2a06)	btgatt.uuid0x2a06
Bluetooth GATT Attribute Alert Notification Control Point (UUID 0x2a44)	BT GATT Alert Notification Control Point (UUID 0x2a44)	btgatt.uuid0x2a44
Bluetooth GATT Attribute Alert Notification Service (UUID 0x1811)	BT GATT Alert Notification Service (UUID 0x1811)	btgatt.uuid0x1811
Bluetooth GATT Attribute Alert Status (UUID 0x2a3f)	BT GATT Alert Status (UUID 0x2a3f)	btgatt.uuid0x2a3f
Bluetooth GATT Attribute Alliance for Wireless Power - Wireless Power Transfer Service (UUID 0xfffe)	BT GATT Alliance for Wireless Power - Wireless Power Transfer Service (UUID 0xfffe)	btgatt.uuid0xfffe
Bluetooth GATT Attribute Altitude (UUID 0x2ab3)	BT GATT Altitude (UUID 0x2ab3)	btgatt.uuid0x2ab3
Bluetooth GATT Attribute Anaerobic Heart Rate Lower Limit (UUID 0x2a81)	BT GATT Anaerobic Heart Rate Lower Limit (UUID 0x2a81)	btgatt.uuid0x2a81
Bluetooth GATT Attribute Anaerobic Heart Rate Upper Limit (UUID 0x2a82)	BT GATT Anaerobic Heart Rate Upper Limit (UUID 0x2a82)	btgatt.uuid0x2a82
Bluetooth GATT Attribute Anaerobic Threshold (UUID 0x2a83)	BT GATT Anaerobic Threshold (UUID 0x2a83)	btgatt.uuid0x2a83
Bluetooth GATT Attribute Analog (UUID 0x2a58)	BT GATT Analog (UUID 0x2a58)	btgatt.uuid0x2a58
Bluetooth GATT Attribute Analog Output (UUID 0x2a59)	BT GATT Analog Output (UUID 0x2a59)	btgatt.uuid0x2a59
Bluetooth GATT Attribute Apparent Wind Direction (UUID 0x2a73)	BT GATT Apparent Wind Direction (UUID 0x2a73)	btgatt.uuid0x2a73
Bluetooth GATT Attribute Apparent Wind Speed (UUID 0x2a72)	BT GATT Apparent Wind Speed (UUID 0x2a72)	btgatt.uuid0x2a72
Bluetooth GATT Attribute Appearance (UUID 0x2a01)	BT GATT Appearance (UUID 0x2a01)	btgatt.uuid0x2a01
Bluetooth GATT Attribute ASTM International - ASTM Remote ID (UUID 0xfffa)	BT GATT ASTM International - ASTM Remote ID (UUID 0xfffa)	btgatt.uuid0xfffa
Bluetooth GATT Attribute Automation IO (UUID 0x1815)	BT GATT Automation IO (UUID 0x1815)	btgatt.uuid0x1815
Bluetooth GATT Attribute Average Current (UUID 0x2ae0)	BT GATT Average Current (UUID 0x2ae0)	btgatt.uuid0x2ae0
Bluetooth GATT Attribute Average Voltage (UUID 0x2ae1)	BT GATT Average Voltage (UUID 0x2ae1)	btgatt.uuid0x2ae1
Bluetooth GATT Attribute Barometric Pressure Trend (UUID 0x2aa3)	BT GATT Barometric Pressure Trend (UUID 0x2aa3)	btgatt.uuid0x2aa3
Bluetooth GATT Attribute Battery Level (UUID 0x2a19)	BT GATT Battery Level (UUID 0x2a19)	btgatt.uuid0x2a19
Bluetooth GATT Attribute Battery Level State (UUID 0x2a1b)	BT GATT Battery Level State (UUID 0x2a1b)	btgatt.uuid0x2a1b
Bluetooth GATT Attribute Battery Power State (UUID 0x2a1a)	BT GATT Battery Power State (UUID 0x2a1a)	btgatt.uuid0x2a1a
Bluetooth GATT Attribute Battery Service (UUID 0x180f)	BT GATT Battery Service (UUID 0x180f)	btgatt.uuid0x180f
Bluetooth GATT Attribute Binary Sensor (UUID 0x183b)	BT GATT Binary Sensor (UUID 0x183b)	btgatt.uuid0x183b
Bluetooth GATT Attribute Blood Pressure (UUID 0x1810)	BT GATT Blood Pressure (UUID 0x1810)	btgatt.uuid0x1810
Bluetooth GATT Attribute Blood Pressure Feature (UUID 0x2a49)	BT GATT Blood Pressure Feature (UUID 0x2a49)	btgatt.uuid0x2a49
Bluetooth GATT Attribute Blood Pressure Measurement (UUID 0x2a35)	BT GATT Blood Pressure Measurement (UUID 0x2a35)	btgatt.uuid0x2a35
Bluetooth GATT Attribute Body Composition (UUID 0x181b)	BT GATT Body Composition (UUID 0x181b)	btgatt.uuid0x181b
Bluetooth GATT Attribute Body Composition Feature (UUID 0x2a9b)	BT GATT Body Composition Feature (UUID 0x2a9b)	btgatt.uuid0x2a9b
Bluetooth GATT Attribute Body Composition Measurement (UUID 0x2a9c)	BT GATT Body Composition Measurement (UUID 0x2a9c)	btgatt.uuid0x2a9c
Bluetooth GATT Attribute Body Sensor Location (UUID 0x2a38)	BT GATT Body Sensor Location (UUID 0x2a38)	btgatt.uuid0x2a38
Bluetooth GATT Attribute Bond Management (UUID 0x181e)	BT GATT Bond Management (UUID 0x181e)	btgatt.uuid0x181e
Bluetooth GATT Attribute Bond Management Control Point (UUID 0x2aa4)	BT GATT Bond Management Control Point (UUID 0x2aa4)	btgatt.uuid0x2aa4
Bluetooth GATT Attribute Bond Management Feature (UUID 0x2aa5)	BT GATT Bond Management Feature (UUID 0x2aa5)	btgatt.uuid0x2aa5
Bluetooth GATT Attribute Boolean (UUID 0x2ae2)	BT GATT Boolean (UUID 0x2ae2)	btgatt.uuid0x2ae2
Bluetooth GATT Attribute Boot Keyboard Input Report (UUID 0x2a22)	BT GATT Boot Keyboard Input Report (UUID 0x2a22)	btgatt.uuid0x2a22
Bluetooth GATT Attribute Boot Keyboard Output Report (UUID 0x2a32)	BT GATT Boot Keyboard Output Report (UUID 0x2a32)	btgatt.uuid0x2a32
Bluetooth GATT Attribute Boot Mouse Input Report (UUID 0x2a33)	BT GATT Boot Mouse Input Report (UUID 0x2a33)	btgatt.uuid0x2a33
Bluetooth GATT Attribute BSS Control Point (UUID 0x2b2b)	BT GATT BSS Control Point (UUID 0x2b2b)	btgatt.uuid0x2b2b
Bluetooth GATT Attribute BSS Response (UUID 0x2b2c)	BT GATT BSS Response (UUID 0x2b2c)	btgatt.uuid0x2b2c
Bluetooth GATT Attribute Central Address Resolution (UUID 0x2aa6)	BT GATT Central Address Resolution (UUID 0x2aa6)	btgatt.uuid0x2aa6
Bluetooth GATT Attribute CGM Feature (UUID 0x2aa8)	BT GATT CGM Feature (UUID 0x2aa8)	btgatt.uuid0x2aa8
Bluetooth GATT Attribute CGM Measurement (UUID 0x2aa7)	BT GATT CGM Measurement (UUID 0x2aa7)	btgatt.uuid0x2aa7
Bluetooth GATT Attribute CGM Session Run Time (UUID 0x2aab)	BT GATT CGM Session Run Time (UUID 0x2aab)	btgatt.uuid0x2aab
Bluetooth GATT Attribute CGM Session Start Time (UUID 0x2aaa)	BT GATT CGM Session Start Time (UUID 0x2aaa)	btgatt.uuid0x2aaa
Bluetooth GATT Attribute CGM Specific Ops Control Point (UUID 0x2aac)	BT GATT CGM Specific Ops Control Point (UUID 0x2aac)	btgatt.uuid0x2aac
Bluetooth GATT Attribute CGM Status (UUID 0x2aa9)	BT GATT CGM Status (UUID 0x2aa9)	btgatt.uuid0x2aa9
Bluetooth GATT Attribute Characteristic Aggregate Format (UUID 0x2905)	BT GATT Characteristic Aggregate Format (UUID 0x2905)	btgatt.uuid0x2905
Bluetooth GATT Attribute Characteristic Extended Properties (UUID 0x2900)	BT GATT Characteristic Extended Properties (UUID 0x2900)	btgatt.uuid0x2900
Bluetooth GATT Attribute Characteristic Presentation Format (UUID 0x2904)	BT GATT Characteristic Presentation Format (UUID 0x2904)	btgatt.uuid0x2904
Bluetooth GATT Attribute Characteristic User Description (UUID 0x2901)	BT GATT Characteristic User Description (UUID 0x2901)	btgatt.uuid0x2901
Bluetooth GATT Attribute Chromatic Distance From Planckian (UUID 0x2ae3)	BT GATT Chromatic Distance From Planckian (UUID 0x2ae3)	btgatt.uuid0x2ae3
Bluetooth GATT Attribute Chromaticity Coordinate (UUID 0x2b1c)	BT GATT Chromaticity Coordinate (UUID 0x2b1c)	btgatt.uuid0x2b1c
Bluetooth GATT Attribute Chromaticity Coordinates (UUID 0x2ae4)	BT GATT Chromaticity Coordinates (UUID 0x2ae4)	btgatt.uuid0x2ae4
Bluetooth GATT Attribute Chromaticity In CCT And Duv Values (UUID 0x2ae5)	BT GATT Chromaticity In CCT And Duv Values (UUID 0x2ae5)	btgatt.uuid0x2ae5
Bluetooth GATT Attribute Chromaticity Tolerance (UUID 0x2ae6)	BT GATT Chromaticity Tolerance (UUID 0x2ae6)	btgatt.uuid0x2ae6
Bluetooth GATT Attribute CIE 13.3-1995 Color Rendering Index (UUID 0x2ae7)	BT GATT CIE 13.3-1995 Color Rendering Index (UUID 0x2ae7)	btgatt.uuid0x2ae7
Bluetooth GATT Attribute Client Characteristic Configuration (UUID 0x2902)	BT GATT Client Characteristic Configuration (UUID 0x2902)	btgatt.uuid0x2902
Bluetooth GATT Attribute Client Supported Features (UUID 0x2b29)	BT GATT Client Supported Features (UUID 0x2b29)	btgatt.uuid0x2b29
Bluetooth GATT Attribute Coefficient (UUID 0x2ae8)	BT GATT Coefficient (UUID 0x2ae8)	btgatt.uuid0x2ae8
Bluetooth GATT Attribute Continuous Glucose Monitoring (UUID 0x181f)	BT GATT Continuous Glucose Monitoring (UUID 0x181f)	btgatt.uuid0x181f
Bluetooth GATT Attribute Correlated Color Temperature (UUID 0x2ae9)	BT GATT Correlated Color Temperature (UUID 0x2ae9)	btgatt.uuid0x2ae9
Bluetooth GATT Attribute Count 16 (UUID 0x2aea)	BT GATT Count 16 (UUID 0x2aea)	btgatt.uuid0x2aea
Bluetooth GATT Attribute Count 24 (UUID 0x2aeb)	BT GATT Count 24 (UUID 0x2aeb)	btgatt.uuid0x2aeb
Bluetooth GATT Attribute Country Code (UUID 0x2aec)	BT GATT Country Code (UUID 0x2aec)	btgatt.uuid0x2aec
Bluetooth GATT Attribute Cross Trainer Data (UUID 0x2ace)	BT GATT Cross Trainer Data (UUID 0x2ace)	btgatt.uuid0x2ace
Bluetooth GATT Attribute CSC Feature (UUID 0x2a5c)	BT GATT CSC Feature (UUID 0x2a5c)	btgatt.uuid0x2a5c
Bluetooth GATT Attribute CSC Measurement (UUID 0x2a5b)	BT GATT CSC Measurement (UUID 0x2a5b)	btgatt.uuid0x2a5b
Bluetooth GATT Attribute Current Time (UUID 0x2a2b)	BT GATT Current Time (UUID 0x2a2b)	btgatt.uuid0x2a2b
Bluetooth GATT Attribute Current Time Service (UUID 0x1805)	BT GATT Current Time Service (UUID 0x1805)	btgatt.uuid0x1805
Bluetooth GATT Attribute Cycling Power (UUID 0x1818)	BT GATT Cycling Power (UUID 0x1818)	btgatt.uuid0x1818
Bluetooth GATT Attribute Cycling Power Control Point (UUID 0x2a66)	BT GATT Cycling Power Control Point (UUID 0x2a66)	btgatt.uuid0x2a66
Bluetooth GATT Attribute Cycling Power Feature (UUID 0x2a65)	BT GATT Cycling Power Feature (UUID 0x2a65)	btgatt.uuid0x2a65
Bluetooth GATT Attribute Cycling Power Measurement (UUID 0x2a63)	BT GATT Cycling Power Measurement (UUID 0x2a63)	btgatt.uuid0x2a63
Bluetooth GATT Attribute Cycling Power Vector (UUID 0x2a64)	BT GATT Cycling Power Vector (UUID 0x2a64)	btgatt.uuid0x2a64
Bluetooth GATT Attribute Cycling Speed and Cadence (UUID 0x1816)	BT GATT Cycling Speed and Cadence (UUID 0x1816)	btgatt.uuid0x1816
Bluetooth GATT Attribute Database Change Increment (UUID 0x2a99)	BT GATT Database Change Increment (UUID 0x2a99)	btgatt.uuid0x2a99
Bluetooth GATT Attribute Database Hash (UUID 0x2b2a)	BT GATT Database Hash (UUID 0x2b2a)	btgatt.uuid0x2b2a
Bluetooth GATT Attribute Date of Birth (UUID 0x2a85)	BT GATT Date of Birth (UUID 0x2a85)	btgatt.uuid0x2a85
Bluetooth GATT Attribute Date of Threshold Assessment (UUID 0x2a86)	BT GATT Date of Threshold Assessment (UUID 0x2a86)	btgatt.uuid0x2a86
Bluetooth GATT Attribute Date Time (UUID 0x2a08)	BT GATT Date Time (UUID 0x2a08)	btgatt.uuid0x2a08
Bluetooth GATT Attribute Date UTC (UUID 0x2aed)	BT GATT Date UTC (UUID 0x2aed)	btgatt.uuid0x2aed
Bluetooth GATT Attribute Day Date Time (UUID 0x2a0a)	BT GATT Day Date Time (UUID 0x2a0a)	btgatt.uuid0x2a0a
Bluetooth GATT Attribute Day of Week (UUID 0x2a09)	BT GATT Day of Week (UUID 0x2a09)	btgatt.uuid0x2a09
Bluetooth GATT Attribute Descriptor Value Changed (UUID 0x2a7d)	BT GATT Descriptor Value Changed (UUID 0x2a7d)	btgatt.uuid0x2a7d
Bluetooth GATT Attribute Device Information (UUID 0x180a)	BT GATT Device Information (UUID 0x180a)	btgatt.uuid0x180a
Bluetooth GATT Attribute Device Name (UUID 0x2a00)	BT GATT Device Name (UUID 0x2a00)	btgatt.uuid0x2a00
Bluetooth GATT Attribute Dew Point (UUID 0x2a7b)	BT GATT Dew Point (UUID 0x2a7b)	btgatt.uuid0x2a7b
Bluetooth GATT Attribute Digital (UUID 0x2a56)	BT GATT Digital (UUID 0x2a56)	btgatt.uuid0x2a56
Bluetooth GATT Attribute Digital Output (UUID 0x2a57)	BT GATT Digital Output (UUID 0x2a57)	btgatt.uuid0x2a57
Bluetooth GATT Attribute DST Offset (UUID 0x2a0d)	BT GATT DST Offset (UUID 0x2a0d)	btgatt.uuid0x2a0d
Bluetooth GATT Attribute Electric Current (UUID 0x2aee)	BT GATT Electric Current (UUID 0x2aee)	btgatt.uuid0x2aee
Bluetooth GATT Attribute Electric Current Range (UUID 0x2aef)	BT GATT Electric Current Range (UUID 0x2aef)	btgatt.uuid0x2aef
Bluetooth GATT Attribute Electric Current Specification (UUID 0x2af0)	BT GATT Electric Current Specification (UUID 0x2af0)	btgatt.uuid0x2af0
Bluetooth GATT Attribute Electric Current Statistics (UUID 0x2af1)	BT GATT Electric Current Statistics (UUID 0x2af1)	btgatt.uuid0x2af1
Bluetooth GATT Attribute Elevation (UUID 0x2a6c)	BT GATT Elevation (UUID 0x2a6c)	btgatt.uuid0x2a6c
Bluetooth GATT Attribute Email Address (UUID 0x2a87)	BT GATT Email Address (UUID 0x2a87)	btgatt.uuid0x2a87
Bluetooth GATT Attribute Emergency Configuration (UUID 0x183c)	BT GATT Emergency Configuration (UUID 0x183c)	btgatt.uuid0x183c
Bluetooth GATT Attribute Emergency ID (UUID 0x2b2d)	BT GATT Emergency ID (UUID 0x2b2d)	btgatt.uuid0x2b2d
Bluetooth GATT Attribute Emergency Text (UUID 0x2b2e)	BT GATT Emergency Text (UUID 0x2b2e)	btgatt.uuid0x2b2e
Bluetooth GATT Attribute Energy (UUID 0x2af2)	BT GATT Energy (UUID 0x2af2)	btgatt.uuid0x2af2
Bluetooth GATT Attribute Energy In A Period Of Day (UUID 0x2af3)	BT GATT Energy In A Period Of Day (UUID 0x2af3)	btgatt.uuid0x2af3
Bluetooth GATT Attribute Environmental Sensing (UUID 0x181a)	BT GATT Environmental Sensing (UUID 0x181a)	btgatt.uuid0x181a
Bluetooth GATT Attribute Environmental Sensing Configuration (UUID 0x290b)	BT GATT Environmental Sensing Configuration (UUID 0x290b)	btgatt.uuid0x290b
Bluetooth GATT Attribute Environmental Sensing Measurement (UUID 0x290c)	BT GATT Environmental Sensing Measurement (UUID 0x290c)	btgatt.uuid0x290c
Bluetooth GATT Attribute Environmental Sensing Trigger Setting (UUID 0x290d)	BT GATT Environmental Sensing Trigger Setting (UUID 0x290d)	btgatt.uuid0x290d
Bluetooth GATT Attribute Event Statistics (UUID 0x2af4)	BT GATT Event Statistics (UUID 0x2af4)	btgatt.uuid0x2af4
Bluetooth GATT Attribute Exact Time 100 (UUID 0x2a0b)	BT GATT Exact Time 100 (UUID 0x2a0b)	btgatt.uuid0x2a0b
Bluetooth GATT Attribute Exact Time 256 (UUID 0x2a0c)	BT GATT Exact Time 256 (UUID 0x2a0c)	btgatt.uuid0x2a0c
Bluetooth GATT Attribute External Report Reference (UUID 0x2907)	BT GATT External Report Reference (UUID 0x2907)	btgatt.uuid0x2907
Bluetooth GATT Attribute Fast IDentity Online Alliance (FIDO) - FIDO2 secure client-to-authenticator transport (UUID 0xfff9)	BT GATT Fast IDentity Online Alliance (FIDO) - FIDO2 secure client-to-authenticator transport (UUID 0xfff9)	btgatt.uuid0xfff9
Bluetooth GATT Attribute Fast IDentity Online Alliance - Universal Second Factor Authenticator Service (UUID 0xfffd)	BT GATT Fast IDentity Online Alliance - Universal Second Factor Authenticator Service (UUID 0xfffd)	btgatt.uuid0xfffd
Bluetooth GATT Attribute Fat Burn Heart Rate Lower Limit (UUID 0x2a88)	BT GATT Fat Burn Heart Rate Lower Limit (UUID 0x2a88)	btgatt.uuid0x2a88
Bluetooth GATT Attribute Fat Burn Heart Rate Upper Limit (UUID 0x2a89)	BT GATT Fat Burn Heart Rate Upper Limit (UUID 0x2a89)	btgatt.uuid0x2a89
Bluetooth GATT Attribute Firmware Revision String (UUID 0x2a26)	BT GATT Firmware Revision String (UUID 0x2a26)	btgatt.uuid0x2a26
Bluetooth GATT Attribute First Name (UUID 0x2a8a)	BT GATT First Name (UUID 0x2a8a)	btgatt.uuid0x2a8a
Bluetooth GATT Attribute Fitness Machine (UUID 0x1826)	BT GATT Fitness Machine (UUID 0x1826)	btgatt.uuid0x1826
Bluetooth GATT Attribute Fitness Machine Control Point (UUID 0x2ad9)	BT GATT Fitness Machine Control Point (UUID 0x2ad9)	btgatt.uuid0x2ad9
Bluetooth GATT Attribute Fitness Machine Feature (UUID 0x2acc)	BT GATT Fitness Machine Feature (UUID 0x2acc)	btgatt.uuid0x2acc
Bluetooth GATT Attribute Fitness Machine Status (UUID 0x2ada)	BT GATT Fitness Machine Status (UUID 0x2ada)	btgatt.uuid0x2ada
Bluetooth GATT Attribute Five Zone Heart Rate Limits (UUID 0x2a8b)	BT GATT Five Zone Heart Rate Limits (UUID 0x2a8b)	btgatt.uuid0x2a8b
Bluetooth GATT Attribute Fixed String 16 (UUID 0x2af5)	BT GATT Fixed String 16 (UUID 0x2af5)	btgatt.uuid0x2af5
Bluetooth GATT Attribute Fixed String 24 (UUID 0x2af6)	BT GATT Fixed String 24 (UUID 0x2af6)	btgatt.uuid0x2af6
Bluetooth GATT Attribute Fixed String 36 (UUID 0x2af7)	BT GATT Fixed String 36 (UUID 0x2af7)	btgatt.uuid0x2af7
Bluetooth GATT Attribute Fixed String 8 (UUID 0x2af8)	BT GATT Fixed String 8 (UUID 0x2af8)	btgatt.uuid0x2af8
Bluetooth GATT Attribute Floor Number (UUID 0x2ab2)	BT GATT Floor Number (UUID 0x2ab2)	btgatt.uuid0x2ab2
Bluetooth GATT Attribute GATT Characteristic Declaration (UUID 0x2803)	BT GATT GATT Characteristic Declaration (UUID 0x2803)	btgatt.uuid0x2803
Bluetooth GATT Attribute GATT Include Declaration (UUID 0x2802)	BT GATT GATT Include Declaration (UUID 0x2802)	btgatt.uuid0x2802
Bluetooth GATT Attribute GATT Primary Service Declaration (UUID 0x2800)	BT GATT GATT Primary Service Declaration (UUID 0x2800)	btgatt.uuid0x2800
Bluetooth GATT Attribute GATT Secondary Service Declaration (UUID 0x2801)	BT GATT GATT Secondary Service Declaration (UUID 0x2801)	btgatt.uuid0x2801
Bluetooth GATT Attribute Gender (UUID 0x2a8c)	BT GATT Gender (UUID 0x2a8c)	btgatt.uuid0x2a8c
Bluetooth GATT Attribute Generic Access Profile (UUID 0x1800)	BT GATT Generic Access Profile (UUID 0x1800)	btgatt.uuid0x1800
Bluetooth GATT Attribute Generic Attribute Profile (UUID 0x1801)	BT GATT Generic Attribute Profile (UUID 0x1801)	btgatt.uuid0x1801
Bluetooth GATT Attribute Generic Level (UUID 0x2af9)	BT GATT Generic Level (UUID 0x2af9)	btgatt.uuid0x2af9
Bluetooth GATT Attribute Global Trade Item Number (UUID 0x2afa)	BT GATT Global Trade Item Number (UUID 0x2afa)	btgatt.uuid0x2afa
Bluetooth GATT Attribute Glucose (UUID 0x1808)	BT GATT Glucose (UUID 0x1808)	btgatt.uuid0x1808
Bluetooth GATT Attribute Glucose Feature (UUID 0x2a51)	BT GATT Glucose Feature (UUID 0x2a51)	btgatt.uuid0x2a51
Bluetooth GATT Attribute Glucose Measurement (UUID 0x2a18)	BT GATT Glucose Measurement (UUID 0x2a18)	btgatt.uuid0x2a18
Bluetooth GATT Attribute Glucose Measurement Context (UUID 0x2a34)	BT GATT Glucose Measurement Context (UUID 0x2a34)	btgatt.uuid0x2a34
Bluetooth GATT Attribute Gust Factor (UUID 0x2a74)	BT GATT Gust Factor (UUID 0x2a74)	btgatt.uuid0x2a74
Bluetooth GATT Attribute Hardware Revision String (UUID 0x2a27)	BT GATT Hardware Revision String (UUID 0x2a27)	btgatt.uuid0x2a27
Bluetooth GATT Attribute Health Thermometer (UUID 0x1809)	BT GATT Health Thermometer (UUID 0x1809)	btgatt.uuid0x1809
Bluetooth GATT Attribute Heart Rate (UUID 0x180d)	BT GATT Heart Rate (UUID 0x180d)	btgatt.uuid0x180d
Bluetooth GATT Attribute Heart Rate Control Point (UUID 0x2a39)	BT GATT Heart Rate Control Point (UUID 0x2a39)	btgatt.uuid0x2a39
Bluetooth GATT Attribute Heart Rate Max (UUID 0x2a8d)	BT GATT Heart Rate Max (UUID 0x2a8d)	btgatt.uuid0x2a8d
Bluetooth GATT Attribute Heart Rate Measurement (UUID 0x2a37)	BT GATT Heart Rate Measurement (UUID 0x2a37)	btgatt.uuid0x2a37
Bluetooth GATT Attribute Heat Index (UUID 0x2a7a)	BT GATT Heat Index (UUID 0x2a7a)	btgatt.uuid0x2a7a
Bluetooth GATT Attribute Height (UUID 0x2a8e)	BT GATT Height (UUID 0x2a8e)	btgatt.uuid0x2a8e
Bluetooth GATT Attribute HID Control Point (UUID 0x2a4c)	BT GATT HID Control Point (UUID 0x2a4c)	btgatt.uuid0x2a4c
Bluetooth GATT Attribute HID Information (UUID 0x2a4a)	BT GATT HID Information (UUID 0x2a4a)	btgatt.uuid0x2a4a
Bluetooth GATT Attribute Hip Circumference (UUID 0x2a8f)	BT GATT Hip Circumference (UUID 0x2a8f)	btgatt.uuid0x2a8f
Bluetooth GATT Attribute HTTP Control Point (UUID 0x2aba)	BT GATT HTTP Control Point (UUID 0x2aba)	btgatt.uuid0x2aba
Bluetooth GATT Attribute HTTP Entity Body (UUID 0x2ab9)	BT GATT HTTP Entity Body (UUID 0x2ab9)	btgatt.uuid0x2ab9
Bluetooth GATT Attribute HTTP Headers (UUID 0x2ab7)	BT GATT HTTP Headers (UUID 0x2ab7)	btgatt.uuid0x2ab7
Bluetooth GATT Attribute HTTP Proxy (UUID 0x1823)	BT GATT HTTP Proxy (UUID 0x1823)	btgatt.uuid0x1823
Bluetooth GATT Attribute HTTP Status Code (UUID 0x2ab8)	BT GATT HTTP Status Code (UUID 0x2ab8)	btgatt.uuid0x2ab8
Bluetooth GATT Attribute HTTPS Security (UUID 0x2abb)	BT GATT HTTPS Security (UUID 0x2abb)	btgatt.uuid0x2abb
Bluetooth GATT Attribute Human Interface Device (UUID 0x1812)	BT GATT Human Interface Device (UUID 0x1812)	btgatt.uuid0x1812
Bluetooth GATT Attribute Humidity (UUID 0x2a6f)	BT GATT Humidity (UUID 0x2a6f)	btgatt.uuid0x2a6f
Bluetooth GATT Attribute IDD Annunciation Status (UUID 0x2b22)	BT GATT IDD Annunciation Status (UUID 0x2b22)	btgatt.uuid0x2b22
Bluetooth GATT Attribute IDD Command Control Point (UUID 0x2b25)	BT GATT IDD Command Control Point (UUID 0x2b25)	btgatt.uuid0x2b25
Bluetooth GATT Attribute IDD Command Data (UUID 0x2b26)	BT GATT IDD Command Data (UUID 0x2b26)	btgatt.uuid0x2b26
Bluetooth GATT Attribute IDD Features (UUID 0x2b23)	BT GATT IDD Features (UUID 0x2b23)	btgatt.uuid0x2b23
Bluetooth GATT Attribute IDD History Data (UUID 0x2b28)	BT GATT IDD History Data (UUID 0x2b28)	btgatt.uuid0x2b28
Bluetooth GATT Attribute IDD Record Access Control Point (UUID 0x2b27)	BT GATT IDD Record Access Control Point (UUID 0x2b27)	btgatt.uuid0x2b27
Bluetooth GATT Attribute IDD Status (UUID 0x2b21)	BT GATT IDD Status (UUID 0x2b21)	btgatt.uuid0x2b21
Bluetooth GATT Attribute IDD Status Changed (UUID 0x2b20)	BT GATT IDD Status Changed (UUID 0x2b20)	btgatt.uuid0x2b20
Bluetooth GATT Attribute IDD Status Reader Control Point (UUID 0x2b24)	BT GATT IDD Status Reader Control Point (UUID 0x2b24)	btgatt.uuid0x2b24
Bluetooth GATT Attribute IEEE 11073-20601 Regulatory Certification Data List (UUID 0x2a2a)	BT GATT IEEE 11073-20601 Regulatory Certification Data List (UUID 0x2a2a)	btgatt.uuid0x2a2a
Bluetooth GATT Attribute Illuminance (UUID 0x2afb)	BT GATT Illuminance (UUID 0x2afb)	btgatt.uuid0x2afb
Bluetooth GATT Attribute Immediate Alert (UUID 0x1802)	BT GATT Immediate Alert (UUID 0x1802)	btgatt.uuid0x1802
Bluetooth GATT Attribute Indoor Bike Data (UUID 0x2ad2)	BT GATT Indoor Bike Data (UUID 0x2ad2)	btgatt.uuid0x2ad2
Bluetooth GATT Attribute Indoor Positioning (UUID 0x1821)	BT GATT Indoor Positioning (UUID 0x1821)	btgatt.uuid0x1821
Bluetooth GATT Attribute Indoor Positioning Configuration (UUID 0x2aad)	BT GATT Indoor Positioning Configuration (UUID 0x2aad)	btgatt.uuid0x2aad
Bluetooth GATT Attribute Insulin Delivery (UUID 0x183a)	BT GATT Insulin Delivery (UUID 0x183a)	btgatt.uuid0x183a
Bluetooth GATT Attribute Intermediate Cuff Pressure (UUID 0x2a36)	BT GATT Intermediate Cuff Pressure (UUID 0x2a36)	btgatt.uuid0x2a36
Bluetooth GATT Attribute Intermediate Temperature (UUID 0x2a1e)	BT GATT Intermediate Temperature (UUID 0x2a1e)	btgatt.uuid0x2a1e
Bluetooth GATT Attribute Internet Protocol Support (UUID 0x1820)	BT GATT Internet Protocol Support (UUID 0x1820)	btgatt.uuid0x1820
Bluetooth GATT Attribute Irradiance (UUID 0x2a77)	BT GATT Irradiance (UUID 0x2a77)	btgatt.uuid0x2a77
Bluetooth GATT Attribute Language (UUID 0x2aa2)	BT GATT Language (UUID 0x2aa2)	btgatt.uuid0x2aa2
Bluetooth GATT Attribute Last Name (UUID 0x2a90)	BT GATT Last Name (UUID 0x2a90)	btgatt.uuid0x2a90
Bluetooth GATT Attribute Latitude (UUID 0x2aae)	BT GATT Latitude (UUID 0x2aae)	btgatt.uuid0x2aae
Bluetooth GATT Attribute Link Loss (UUID 0x1803)	BT GATT Link Loss (UUID 0x1803)	btgatt.uuid0x1803
Bluetooth GATT Attribute LN Control Point (UUID 0x2a6b)	BT GATT LN Control Point (UUID 0x2a6b)	btgatt.uuid0x2a6b
Bluetooth GATT Attribute LN Feature (UUID 0x2a6a)	BT GATT LN Feature (UUID 0x2a6a)	btgatt.uuid0x2a6a
Bluetooth GATT Attribute Local East Coordinate (UUID 0x2ab1)	BT GATT Local East Coordinate (UUID 0x2ab1)	btgatt.uuid0x2ab1
Bluetooth GATT Attribute Local North Coordinate (UUID 0x2ab0)	BT GATT Local North Coordinate (UUID 0x2ab0)	btgatt.uuid0x2ab0
Bluetooth GATT Attribute Local Time Information (UUID 0x2a0f)	BT GATT Local Time Information (UUID 0x2a0f)	btgatt.uuid0x2a0f
Bluetooth GATT Attribute Location and Navigation (UUID 0x1819)	BT GATT Location and Navigation (UUID 0x1819)	btgatt.uuid0x1819
Bluetooth GATT Attribute Location and Speed (UUID 0x2a67)	BT GATT Location and Speed (UUID 0x2a67)	btgatt.uuid0x2a67
Bluetooth GATT Attribute Location Name (UUID 0x2ab5)	BT GATT Location Name (UUID 0x2ab5)	btgatt.uuid0x2ab5
Bluetooth GATT Attribute Longitude (UUID 0x2aaf)	BT GATT Longitude (UUID 0x2aaf)	btgatt.uuid0x2aaf
Bluetooth GATT Attribute Luminous Efficacy (UUID 0x2afc)	BT GATT Luminous Efficacy (UUID 0x2afc)	btgatt.uuid0x2afc
Bluetooth GATT Attribute Luminous Energy (UUID 0x2afd)	BT GATT Luminous Energy (UUID 0x2afd)	btgatt.uuid0x2afd
Bluetooth GATT Attribute Luminous Exposure (UUID 0x2afe)	BT GATT Luminous Exposure (UUID 0x2afe)	btgatt.uuid0x2afe
Bluetooth GATT Attribute Luminous Flux (UUID 0x2aff)	BT GATT Luminous Flux (UUID 0x2aff)	btgatt.uuid0x2aff
Bluetooth GATT Attribute Luminous Flux Range (UUID 0x2b00)	BT GATT Luminous Flux Range (UUID 0x2b00)	btgatt.uuid0x2b00
Bluetooth GATT Attribute Luminous Intensity (UUID 0x2b01)	BT GATT Luminous Intensity (UUID 0x2b01)	btgatt.uuid0x2b01
Bluetooth GATT Attribute Magnetic Declination (UUID 0x2a2c)	BT GATT Magnetic Declination (UUID 0x2a2c)	btgatt.uuid0x2a2c
Bluetooth GATT Attribute Magnetic Flux Density - 2D (UUID 0x2aa0)	BT GATT Magnetic Flux Density - 2D (UUID 0x2aa0)	btgatt.uuid0x2aa0
Bluetooth GATT Attribute Magnetic Flux Density - 3D (UUID 0x2aa1)	BT GATT Magnetic Flux Density - 3D (UUID 0x2aa1)	btgatt.uuid0x2aa1
Bluetooth GATT Attribute Manufacturer Name String (UUID 0x2a29)	BT GATT Manufacturer Name String (UUID 0x2a29)	btgatt.uuid0x2a29
Bluetooth GATT Attribute Mass Flow (UUID 0x2b02)	BT GATT Mass Flow (UUID 0x2b02)	btgatt.uuid0x2b02
Bluetooth GATT Attribute Maximum Recommended Heart Rate (UUID 0x2a91)	BT GATT Maximum Recommended Heart Rate (UUID 0x2a91)	btgatt.uuid0x2a91
Bluetooth GATT Attribute Measurement Interval (UUID 0x2a21)	BT GATT Measurement Interval (UUID 0x2a21)	btgatt.uuid0x2a21
Bluetooth GATT Attribute Mesh Provisioning Data In (UUID 0x2adb)	BT GATT Mesh Provisioning Data In (UUID 0x2adb)	btgatt.uuid0x2adb
Bluetooth GATT Attribute Mesh Provisioning Data Out (UUID 0x2adc)	BT GATT Mesh Provisioning Data Out (UUID 0x2adc)	btgatt.uuid0x2adc
Bluetooth GATT Attribute Mesh Provisioning Service (UUID 0x1827)	BT GATT Mesh Provisioning Service (UUID 0x1827)	btgatt.uuid0x1827
Bluetooth GATT Attribute Mesh Proxy Data In (UUID 0x2add)	BT GATT Mesh Proxy Data In (UUID 0x2add)	btgatt.uuid0x2add
Bluetooth GATT Attribute Mesh Proxy Data Out (UUID 0x2ade)	BT GATT Mesh Proxy Data Out (UUID 0x2ade)	btgatt.uuid0x2ade
Bluetooth GATT Attribute Mesh Proxy Service (UUID 0x1828)	BT GATT Mesh Proxy Service (UUID 0x1828)	btgatt.uuid0x1828
Bluetooth GATT Attribute Model Number String (UUID 0x2a24)	BT GATT Model Number String (UUID 0x2a24)	btgatt.uuid0x2a24
Bluetooth GATT Attribute Mopria Alliance - Mopria Alliance BLE Service (UUID 0xfff8)	BT GATT Mopria Alliance - Mopria Alliance BLE Service (UUID 0xfff8)	btgatt.uuid0xfff8
Bluetooth GATT Attribute Navigation (UUID 0x2a68)	BT GATT Navigation (UUID 0x2a68)	btgatt.uuid0x2a68
Bluetooth GATT Attribute Network Availability (UUID 0x2a3e)	BT GATT Network Availability (UUID 0x2a3e)	btgatt.uuid0x2a3e
Bluetooth GATT Attribute New Alert (UUID 0x2a46)	BT GATT New Alert (UUID 0x2a46)	btgatt.uuid0x2a46
Bluetooth GATT Attribute Next DST Change Service (UUID 0x1807)	BT GATT Next DST Change Service (UUID 0x1807)	btgatt.uuid0x1807
Bluetooth GATT Attribute Number of Digitals (UUID 0x2909)	BT GATT Number of Digitals (UUID 0x2909)	btgatt.uuid0x2909
Bluetooth GATT Attribute Object Action Control Point (UUID 0x2ac5)	BT GATT Object Action Control Point (UUID 0x2ac5)	btgatt.uuid0x2ac5
Bluetooth GATT Attribute Object Changed (UUID 0x2ac8)	BT GATT Object Changed (UUID 0x2ac8)	btgatt.uuid0x2ac8
Bluetooth GATT Attribute Object First-Created (UUID 0x2ac1)	BT GATT Object First-Created (UUID 0x2ac1)	btgatt.uuid0x2ac1
Bluetooth GATT Attribute Object ID (UUID 0x2ac3)	BT GATT Object ID (UUID 0x2ac3)	btgatt.uuid0x2ac3
Bluetooth GATT Attribute Object Last-Modified (UUID 0x2ac2)	BT GATT Object Last-Modified (UUID 0x2ac2)	btgatt.uuid0x2ac2
Bluetooth GATT Attribute Object List Control Point (UUID 0x2ac6)	BT GATT Object List Control Point (UUID 0x2ac6)	btgatt.uuid0x2ac6
Bluetooth GATT Attribute Object List Filter (UUID 0x2ac7)	BT GATT Object List Filter (UUID 0x2ac7)	btgatt.uuid0x2ac7
Bluetooth GATT Attribute Object Name (UUID 0x2abe)	BT GATT Object Name (UUID 0x2abe)	btgatt.uuid0x2abe
Bluetooth GATT Attribute Object Properties (UUID 0x2ac4)	BT GATT Object Properties (UUID 0x2ac4)	btgatt.uuid0x2ac4
Bluetooth GATT Attribute Object Size (UUID 0x2ac0)	BT GATT Object Size (UUID 0x2ac0)	btgatt.uuid0x2ac0
Bluetooth GATT Attribute Object Transfer (UUID 0x1825)	BT GATT Object Transfer (UUID 0x1825)	btgatt.uuid0x1825
Bluetooth GATT Attribute Object Type (UUID 0x2abf)	BT GATT Object Type (UUID 0x2abf)	btgatt.uuid0x2abf
Bluetooth GATT Attribute OTS Feature (UUID 0x2abd)	BT GATT OTS Feature (UUID 0x2abd)	btgatt.uuid0x2abd
Bluetooth GATT Attribute Perceived Lightness (UUID 0x2b03)	BT GATT Perceived Lightness (UUID 0x2b03)	btgatt.uuid0x2b03
Bluetooth GATT Attribute Percentage 8 (UUID 0x2b04)	BT GATT Percentage 8 (UUID 0x2b04)	btgatt.uuid0x2b04
Bluetooth GATT Attribute Peripheral Preferred Connection Parameters (UUID 0x2a04)	BT GATT Peripheral Preferred Connection Parameters (UUID 0x2a04)	btgatt.uuid0x2a04
Bluetooth GATT Attribute Peripheral Privacy Flag (UUID 0x2a02)	BT GATT Peripheral Privacy Flag (UUID 0x2a02)	btgatt.uuid0x2a02
Bluetooth GATT Attribute Phone Alert Status Service (UUID 0x180e)	BT GATT Phone Alert Status Service (UUID 0x180e)	btgatt.uuid0x180e
Bluetooth GATT Attribute PLX Continuous Measurement (UUID 0x2a5f)	BT GATT PLX Continuous Measurement (UUID 0x2a5f)	btgatt.uuid0x2a5f
Bluetooth GATT Attribute PLX Features (UUID 0x2a60)	BT GATT PLX Features (UUID 0x2a60)	btgatt.uuid0x2a60
Bluetooth GATT Attribute PLX Spot-Check Measurement (UUID 0x2a5e)	BT GATT PLX Spot-Check Measurement (UUID 0x2a5e)	btgatt.uuid0x2a5e
Bluetooth GATT Attribute PnP ID (UUID 0x2a50)	BT GATT PnP ID (UUID 0x2a50)	btgatt.uuid0x2a50
Bluetooth GATT Attribute Pollen Concentration (UUID 0x2a75)	BT GATT Pollen Concentration (UUID 0x2a75)	btgatt.uuid0x2a75
Bluetooth GATT Attribute Position 2D (UUID 0x2a2f)	BT GATT Position 2D (UUID 0x2a2f)	btgatt.uuid0x2a2f
Bluetooth GATT Attribute Position 3D (UUID 0x2a30)	BT GATT Position 3D (UUID 0x2a30)	btgatt.uuid0x2a30
Bluetooth GATT Attribute Position Quality (UUID 0x2a69)	BT GATT Position Quality (UUID 0x2a69)	btgatt.uuid0x2a69
Bluetooth GATT Attribute Power (UUID 0x2b05)	BT GATT Power (UUID 0x2b05)	btgatt.uuid0x2b05
Bluetooth GATT Attribute Power Specification (UUID 0x2b06)	BT GATT Power Specification (UUID 0x2b06)	btgatt.uuid0x2b06
Bluetooth GATT Attribute Pressure (UUID 0x2a6d)	BT GATT Pressure (UUID 0x2a6d)	btgatt.uuid0x2a6d
Bluetooth GATT Attribute Protocol Mode (UUID 0x2a4e)	BT GATT Protocol Mode (UUID 0x2a4e)	btgatt.uuid0x2a4e
Bluetooth GATT Attribute Pulse Oximeter (UUID 0x1822)	BT GATT Pulse Oximeter (UUID 0x1822)	btgatt.uuid0x1822
Bluetooth GATT Attribute Pulse Oximetry Control Point (UUID 0x2a62)	BT GATT Pulse Oximetry Control Point (UUID 0x2a62)	btgatt.uuid0x2a62
Bluetooth GATT Attribute Rainfall (UUID 0x2a78)	BT GATT Rainfall (UUID 0x2a78)	btgatt.uuid0x2a78
Bluetooth GATT Attribute Reconnection Address (UUID 0x2a03)	BT GATT Reconnection Address (UUID 0x2a03)	btgatt.uuid0x2a03
Bluetooth GATT Attribute Reconnection Configuration (UUID 0x1829)	BT GATT Reconnection Configuration (UUID 0x1829)	btgatt.uuid0x1829
Bluetooth GATT Attribute Reconnection Configuration Control Point (UUID 0x2b1f)	BT GATT Reconnection Configuration Control Point (UUID 0x2b1f)	btgatt.uuid0x2b1f
Bluetooth GATT Attribute Reconnection Configuration Feature (UUID 0x2b1d)	BT GATT Reconnection Configuration Feature (UUID 0x2b1d)	btgatt.uuid0x2b1d
Bluetooth GATT Attribute Reconnection Configuration Settings (UUID 0x2b1e)	BT GATT Reconnection Configuration Settings (UUID 0x2b1e)	btgatt.uuid0x2b1e
Bluetooth GATT Attribute Record Access Control Point (UUID 0x2a52)	BT GATT Record Access Control Point (UUID 0x2a52)	btgatt.uuid0x2a52
Bluetooth GATT Attribute Reference Time Information (UUID 0x2a14)	BT GATT Reference Time Information (UUID 0x2a14)	btgatt.uuid0x2a14
Bluetooth GATT Attribute Reference Time Update Service (UUID 0x1806)	BT GATT Reference Time Update Service (UUID 0x1806)	btgatt.uuid0x1806
Bluetooth GATT Attribute Registered User Characteristic (UUID 0x2b37)	BT GATT Registered User Characteristic (UUID 0x2b37)	btgatt.uuid0x2b37
Bluetooth GATT Attribute Relative Runtime In A Current Range (UUID 0x2b07)	BT GATT Relative Runtime In A Current Range (UUID 0x2b07)	btgatt.uuid0x2b07
Bluetooth GATT Attribute Relative Runtime In A Generic Level Range (UUID 0x2b08)	BT GATT Relative Runtime In A Generic Level Range (UUID 0x2b08)	btgatt.uuid0x2b08
Bluetooth GATT Attribute Relative Value In A Period of Day (UUID 0x2b0b)	BT GATT Relative Value In A Period of Day (UUID 0x2b0b)	btgatt.uuid0x2b0b
Bluetooth GATT Attribute Relative Value In A Temperature Range (UUID 0x2b0c)	BT GATT Relative Value In A Temperature Range (UUID 0x2b0c)	btgatt.uuid0x2b0c
Bluetooth GATT Attribute Relative Value In A Voltage Range (UUID 0x2b09)	BT GATT Relative Value In A Voltage Range (UUID 0x2b09)	btgatt.uuid0x2b09
Bluetooth GATT Attribute Relative Value In An Illuminance Range (UUID 0x2b0a)	BT GATT Relative Value In An Illuminance Range (UUID 0x2b0a)	btgatt.uuid0x2b0a
Bluetooth GATT Attribute Removable (UUID 0x2a3a)	BT GATT Removable (UUID 0x2a3a)	btgatt.uuid0x2a3a
Bluetooth GATT Attribute Report (UUID 0x2a4d)	BT GATT Report (UUID 0x2a4d)	btgatt.uuid0x2a4d
Bluetooth GATT Attribute Report Map (UUID 0x2a4b)	BT GATT Report Map (UUID 0x2a4b)	btgatt.uuid0x2a4b
Bluetooth GATT Attribute Report Reference (UUID 0x2908)	BT GATT Report Reference (UUID 0x2908)	btgatt.uuid0x2908
Bluetooth GATT Attribute Resolvable Private Address Only (UUID 0x2ac9)	BT GATT Resolvable Private Address Only (UUID 0x2ac9)	btgatt.uuid0x2ac9
Bluetooth GATT Attribute Resting Heart Rate (UUID 0x2a92)	BT GATT Resting Heart Rate (UUID 0x2a92)	btgatt.uuid0x2a92
Bluetooth GATT Attribute Ringer Control Point (UUID 0x2a40)	BT GATT Ringer Control Point (UUID 0x2a40)	btgatt.uuid0x2a40
Bluetooth GATT Attribute Ringer Setting (UUID 0x2a41)	BT GATT Ringer Setting (UUID 0x2a41)	btgatt.uuid0x2a41
Bluetooth GATT Attribute Rower Data (UUID 0x2ad1)	BT GATT Rower Data (UUID 0x2ad1)	btgatt.uuid0x2ad1
Bluetooth GATT Attribute RSC Feature (UUID 0x2a54)	BT GATT RSC Feature (UUID 0x2a54)	btgatt.uuid0x2a54
Bluetooth GATT Attribute RSC Measurement (UUID 0x2a53)	BT GATT RSC Measurement (UUID 0x2a53)	btgatt.uuid0x2a53
Bluetooth GATT Attribute Running Speed and Cadence (UUID 0x1814)	BT GATT Running Speed and Cadence (UUID 0x1814)	btgatt.uuid0x1814
Bluetooth GATT Attribute SC Control Point (UUID 0x2a55)	BT GATT SC Control Point (UUID 0x2a55)	btgatt.uuid0x2a55
Bluetooth GATT Attribute Scan Interval Window (UUID 0x2a4f)	BT GATT Scan Interval Window (UUID 0x2a4f)	btgatt.uuid0x2a4f
Bluetooth GATT Attribute Scan Parameters (UUID 0x1813)	BT GATT Scan Parameters (UUID 0x1813)	btgatt.uuid0x1813
Bluetooth GATT Attribute Scan Refresh (UUID 0x2a31)	BT GATT Scan Refresh (UUID 0x2a31)	btgatt.uuid0x2a31
Bluetooth GATT Attribute Scientific Temperature Celsius (UUID 0x2a3c)	BT GATT Scientific Temperature Celsius (UUID 0x2a3c)	btgatt.uuid0x2a3c
Bluetooth GATT Attribute Secondary Time Zone (UUID 0x2a10)	BT GATT Secondary Time Zone (UUID 0x2a10)	btgatt.uuid0x2a10
Bluetooth GATT Attribute Sensor Location (UUID 0x2a5d)	BT GATT Sensor Location (UUID 0x2a5d)	btgatt.uuid0x2a5d
Bluetooth GATT Attribute Serial Number String (UUID 0x2a25)	BT GATT Serial Number String (UUID 0x2a25)	btgatt.uuid0x2a25
Bluetooth GATT Attribute Server Characteristic Configuration (UUID 0x2903)	BT GATT Server Characteristic Configuration (UUID 0x2903)	btgatt.uuid0x2903
Bluetooth GATT Attribute Server Supported Features (UUID 0x2b3a)	BT GATT Server Supported Features (UUID 0x2b3a)	btgatt.uuid0x2b3a
Bluetooth GATT Attribute Service Changed (UUID 0x2a05)	BT GATT Service Changed (UUID 0x2a05)	btgatt.uuid0x2a05
Bluetooth GATT Attribute Service Required (UUID 0x2a3b)	BT GATT Service Required (UUID 0x2a3b)	btgatt.uuid0x2a3b
Bluetooth GATT Attribute Software Revision String (UUID 0x2a28)	BT GATT Software Revision String (UUID 0x2a28)	btgatt.uuid0x2a28
Bluetooth GATT Attribute Sport Type for Aerobic and Anaerobic Thresholds (UUID 0x2a93)	BT GATT Sport Type for Aerobic and Anaerobic Thresholds (UUID 0x2a93)	btgatt.uuid0x2a93
Bluetooth GATT Attribute Stair Climber Data (UUID 0x2ad0)	BT GATT Stair Climber Data (UUID 0x2ad0)	btgatt.uuid0x2ad0
Bluetooth GATT Attribute Step Climber Data (UUID 0x2acf)	BT GATT Step Climber Data (UUID 0x2acf)	btgatt.uuid0x2acf
Bluetooth GATT Attribute String (UUID 0x2a3d)	BT GATT String (UUID 0x2a3d)	btgatt.uuid0x2a3d
Bluetooth GATT Attribute Supported Heart Rate Range (UUID 0x2ad7)	BT GATT Supported Heart Rate Range (UUID 0x2ad7)	btgatt.uuid0x2ad7
Bluetooth GATT Attribute Supported Inclination Range (UUID 0x2ad5)	BT GATT Supported Inclination Range (UUID 0x2ad5)	btgatt.uuid0x2ad5
Bluetooth GATT Attribute Supported New Alert Category (UUID 0x2a47)	BT GATT Supported New Alert Category (UUID 0x2a47)	btgatt.uuid0x2a47
Bluetooth GATT Attribute Supported Power Range (UUID 0x2ad8)	BT GATT Supported Power Range (UUID 0x2ad8)	btgatt.uuid0x2ad8
Bluetooth GATT Attribute Supported Resistance Level Range (UUID 0x2ad6)	BT GATT Supported Resistance Level Range (UUID 0x2ad6)	btgatt.uuid0x2ad6
Bluetooth GATT Attribute Supported Speed Range (UUID 0x2ad4)	BT GATT Supported Speed Range (UUID 0x2ad4)	btgatt.uuid0x2ad4
Bluetooth GATT Attribute Supported Unread Alert Category (UUID 0x2a48)	BT GATT Supported Unread Alert Category (UUID 0x2a48)	btgatt.uuid0x2a48
Bluetooth GATT Attribute System ID (UUID 0x2a23)	BT GATT System ID (UUID 0x2a23)	btgatt.uuid0x2a23
Bluetooth GATT Attribute TDS Control Point (UUID 0x2abc)	BT GATT TDS Control Point (UUID 0x2abc)	btgatt.uuid0x2abc
Bluetooth GATT Attribute Temperature (UUID 0x2a6e)	BT GATT Temperature (UUID 0x2a6e)	btgatt.uuid0x2a6e
Bluetooth GATT Attribute Temperature 8 (UUID 0x2b0d)	BT GATT Temperature 8 (UUID 0x2b0d)	btgatt.uuid0x2b0d
Bluetooth GATT Attribute Temperature 8 In A Period Of Day (UUID 0x2b0e)	BT GATT Temperature 8 In A Period Of Day (UUID 0x2b0e)	btgatt.uuid0x2b0e
Bluetooth GATT Attribute Temperature 8 Statistics (UUID 0x2b0f)	BT GATT Temperature 8 Statistics (UUID 0x2b0f)	btgatt.uuid0x2b0f
Bluetooth GATT Attribute Temperature Celsius (UUID 0x2a1f)	BT GATT Temperature Celsius (UUID 0x2a1f)	btgatt.uuid0x2a1f
Bluetooth GATT Attribute Temperature Fahrenheit (UUID 0x2a20)	BT GATT Temperature Fahrenheit (UUID 0x2a20)	btgatt.uuid0x2a20
Bluetooth GATT Attribute Temperature Measurement (UUID 0x2a1c)	BT GATT Temperature Measurement (UUID 0x2a1c)	btgatt.uuid0x2a1c
Bluetooth GATT Attribute Temperature Range (UUID 0x2b10)	BT GATT Temperature Range (UUID 0x2b10)	btgatt.uuid0x2b10
Bluetooth GATT Attribute Temperature Statistics (UUID 0x2b11)	BT GATT Temperature Statistics (UUID 0x2b11)	btgatt.uuid0x2b11
Bluetooth GATT Attribute Temperature Type (UUID 0x2a1d)	BT GATT Temperature Type (UUID 0x2a1d)	btgatt.uuid0x2a1d
Bluetooth GATT Attribute Thread Group, Inc. - Direct Thread Commissioning (UUID 0xfffb)	BT GATT Thread Group, Inc. - Direct Thread Commissioning (UUID 0xfffb)	btgatt.uuid0xfffb
Bluetooth GATT Attribute Three Zone Heart Rate Limits (UUID 0x2a94)	BT GATT Three Zone Heart Rate Limits (UUID 0x2a94)	btgatt.uuid0x2a94
Bluetooth GATT Attribute Time Accuracy (UUID 0x2a12)	BT GATT Time Accuracy (UUID 0x2a12)	btgatt.uuid0x2a12
Bluetooth GATT Attribute Time Broadcast (UUID 0x2a15)	BT GATT Time Broadcast (UUID 0x2a15)	btgatt.uuid0x2a15
Bluetooth GATT Attribute Time Decihour 8 (UUID 0x2b12)	BT GATT Time Decihour 8 (UUID 0x2b12)	btgatt.uuid0x2b12
Bluetooth GATT Attribute Time Exponential 8 (UUID 0x2b13)	BT GATT Time Exponential 8 (UUID 0x2b13)	btgatt.uuid0x2b13
Bluetooth GATT Attribute Time Hour 24 (UUID 0x2b14)	BT GATT Time Hour 24 (UUID 0x2b14)	btgatt.uuid0x2b14
Bluetooth GATT Attribute Time Millisecond 24 (UUID 0x2b15)	BT GATT Time Millisecond 24 (UUID 0x2b15)	btgatt.uuid0x2b15
Bluetooth GATT Attribute Time Second 16 (UUID 0x2b16)	BT GATT Time Second 16 (UUID 0x2b16)	btgatt.uuid0x2b16
Bluetooth GATT Attribute Time Second 8 (UUID 0x2b17)	BT GATT Time Second 8 (UUID 0x2b17)	btgatt.uuid0x2b17
Bluetooth GATT Attribute Time Source (UUID 0x2a13)	BT GATT Time Source (UUID 0x2a13)	btgatt.uuid0x2a13
Bluetooth GATT Attribute Time Trigger Setting (UUID 0x290e)	BT GATT Time Trigger Setting (UUID 0x290e)	btgatt.uuid0x290e
Bluetooth GATT Attribute Time Update Control Point (UUID 0x2a16)	BT GATT Time Update Control Point (UUID 0x2a16)	btgatt.uuid0x2a16
Bluetooth GATT Attribute Time Update State (UUID 0x2a17)	BT GATT Time Update State (UUID 0x2a17)	btgatt.uuid0x2a17
Bluetooth GATT Attribute Time with DST (UUID 0x2a11)	BT GATT Time with DST (UUID 0x2a11)	btgatt.uuid0x2a11
Bluetooth GATT Attribute Time Zone (UUID 0x2a0e)	BT GATT Time Zone (UUID 0x2a0e)	btgatt.uuid0x2a0e
Bluetooth GATT Attribute Training Status (UUID 0x2ad3)	BT GATT Training Status (UUID 0x2ad3)	btgatt.uuid0x2ad3
Bluetooth GATT Attribute Transport Discovery (UUID 0x1824)	BT GATT Transport Discovery (UUID 0x1824)	btgatt.uuid0x1824
Bluetooth GATT Attribute Treadmill Data (UUID 0x2acd)	BT GATT Treadmill Data (UUID 0x2acd)	btgatt.uuid0x2acd
Bluetooth GATT Attribute True Wind Direction (UUID 0x2a71)	BT GATT True Wind Direction (UUID 0x2a71)	btgatt.uuid0x2a71
Bluetooth GATT Attribute True Wind Speed (UUID 0x2a70)	BT GATT True Wind Speed (UUID 0x2a70)	btgatt.uuid0x2a70
Bluetooth GATT Attribute Two Zone Heart Rate Limit (UUID 0x2a95)	BT GATT Two Zone Heart Rate Limit (UUID 0x2a95)	btgatt.uuid0x2a95
Bluetooth GATT Attribute Tx Power (UUID 0x1804)	BT GATT Tx Power (UUID 0x1804)	btgatt.uuid0x1804
Bluetooth GATT Attribute Tx Power Level (UUID 0x2a07)	BT GATT Tx Power Level (UUID 0x2a07)	btgatt.uuid0x2a07
Bluetooth GATT Attribute Uncertainty (UUID 0x2ab4)	BT GATT Uncertainty (UUID 0x2ab4)	btgatt.uuid0x2ab4
Bluetooth GATT Attribute Unread Alert Status (UUID 0x2a45)	BT GATT Unread Alert Status (UUID 0x2a45)	btgatt.uuid0x2a45
Bluetooth GATT Attribute URI (UUID 0x2ab6)	BT GATT URI (UUID 0x2ab6)	btgatt.uuid0x2ab6
Bluetooth GATT Attribute User Control Point (UUID 0x2a9f)	BT GATT User Control Point (UUID 0x2a9f)	btgatt.uuid0x2a9f
Bluetooth GATT Attribute User Data (UUID 0x181c)	BT GATT User Data (UUID 0x181c)	btgatt.uuid0x181c
Bluetooth GATT Attribute User Index (UUID 0x2a9a)	BT GATT User Index (UUID 0x2a9a)	btgatt.uuid0x2a9a
Bluetooth GATT Attribute UV Index (UUID 0x2a76)	BT GATT UV Index (UUID 0x2a76)	btgatt.uuid0x2a76
Bluetooth GATT Attribute Valid Range (UUID 0x2906)	BT GATT Valid Range (UUID 0x2906)	btgatt.uuid0x2906
Bluetooth GATT Attribute Value Trigger Setting (UUID 0x290a)	BT GATT Value Trigger Setting (UUID 0x290a)	btgatt.uuid0x290a
Bluetooth GATT Attribute VO2 Max (UUID 0x2a96)	BT GATT VO2 Max (UUID 0x2a96)	btgatt.uuid0x2a96
Bluetooth GATT Attribute Voltage (UUID 0x2b18)	BT GATT Voltage (UUID 0x2b18)	btgatt.uuid0x2b18
Bluetooth GATT Attribute Voltage Specification (UUID 0x2b19)	BT GATT Voltage Specification (UUID 0x2b19)	btgatt.uuid0x2b19
Bluetooth GATT Attribute Voltage Statistics (UUID 0x2b1a)	BT GATT Voltage Statistics (UUID 0x2b1a)	btgatt.uuid0x2b1a
Bluetooth GATT Attribute Volume Flow (UUID 0x2b1b)	BT GATT Volume Flow (UUID 0x2b1b)	btgatt.uuid0x2b1b
Bluetooth GATT Attribute Waist Circumference (UUID 0x2a97)	BT GATT Waist Circumference (UUID 0x2a97)	btgatt.uuid0x2a97
Bluetooth GATT Attribute Weight (UUID 0x2a98)	BT GATT Weight (UUID 0x2a98)	btgatt.uuid0x2a98
Bluetooth GATT Attribute Weight Measurement (UUID 0x2a9d)	BT GATT Weight Measurement (UUID 0x2a9d)	btgatt.uuid0x2a9d
Bluetooth GATT Attribute Weight Scale (UUID 0x181d)	BT GATT Weight Scale (UUID 0x181d)	btgatt.uuid0x181d
Bluetooth GATT Attribute Weight Scale Feature (UUID 0x2a9e)	BT GATT Weight Scale Feature (UUID 0x2a9e)	btgatt.uuid0x2a9e
Bluetooth GATT Attribute Wind Chill (UUID 0x2a79)	BT GATT Wind Chill (UUID 0x2a79)	btgatt.uuid0x2a79
Bluetooth GNSS Profile	BT GNSS	btgnss
Bluetooth OBEX GPP Application Parameters	BT GPP Application Parameters	obex.parameter.bt.gpp
Bluetooth HCRP Profile	BT HCRP	bthcrp
Bluetooth HFP Profile	BT HFP	bthfp
Bluetooth HID Profile	BT HID	bthid
Bluetooth HSP Profile	BT HSP	bthsp
Bluetooth ISO Data	BT ISO Data	bthci_iso_data
Bluetooth L2CAP Protocol	BT L2CAP	btl2cap
Bluetooth Low Energy Link Layer	BT LE LL	btle
Bluetooth Link Manager Protocol	BT LMP	btlmp
Bluetooth OBEX MAP Application Parameters	BT MAP Application Parameters	obex.parameter.bt.map
Bluetooth MCAP Protocol	BT MCAP	btmcap
Bluetooth Mesh	BT Mesh	btmesh
Bluetooth Mesh Beacon	BT Mesh beacon	beacon
Bluetooth Mesh PB-ADV	BT Mesh PB-ADV	pbadv
Bluetooth Mesh Provisioning PDU	BT Mesh Provisioning	provisioning
Bluetooth Mesh Proxy	BT Mesh proxy	btmproxy
Bluetooth OBEX PBAP Application Parameters	BT PBAP Application Parameters	obex.parameter.bt.pbap
Bluetooth RFCOMM Protocol	BT RFCOMM	btrfcomm
Bluetooth SAP Profile	BT SAP	btsap
Bluetooth SDP Protocol	BT SDP	btsdp
Bluetooth Security Manager Protocol	BT SMP	btsmp
Bluetooth SPP Packet	BT SPP	btspp
Bluetooth VDP Profile	BT VDP	btvdp
Bluetooth VDP Content Protection Header SCMS-T	BT VDP Content Protection Header SCMS-T	btvdp_content_protection_header_scms_t
BitTorrent DHT Protocol	BT-DHT	bt-dht
uTorrent Transport Protocol	BT-uTP	bt-utp
Bluetooth Low Energy RF Info	BTLE RF	btle_rf
BTP-A	BTPA	btpa
BTP-B	BTPB	btpb
Symbian OS BTSNOOP File Format	BTSNOOP	btsnoop
DCE/DFS BUDB	BUDB	budb
DCE/RPC BUTC	BUTC	butc
BACnet Virtual Link Control	BVLC	bvlc
ANSI C12.22	C12.22	c1222
C15 Call History Protocol	C15	c15
C15 Call History Common Header Protocol	C15.ch	c15.ch
C15 Incoming GWE	C15.INC_GWE	c15.inc_gwe
C15 Outgoing GWE	C15.out_gwe	c15.out_gwe
C15 Tone	C15.TONE	c15.tone
C15 Call History Heartbeat Protocol	C15HBEAT	c15hbeat
Calculation Application Protocol	CalcAppProtocol	calcappprotocol
Call Status	Call Status	bap.opt.call_status
Callback	Callback	lcp.opt.callback
Callback to a pre-specified or admin-specified number	Callback to a pre-specified or admin-specified number	cbcp.opt.callback_admin
Callback to a user-specified number	Callback to a user-specified number	cbcp.opt.callback_user
Callback to any of a list of numbers	Callback to any of a list of numbers	cbcp.opt.callback_list
ITS message - CAM	CAM	its.message.cam
Camel	CAMEL	camel
ITS message - CAMv1	CAMv1	its.message.camv1
Controller Area Network	CAN	can
ACF CAN	CAN over AVTP	acf-can
Controller Area Network over Ethernet	CAN-ETH	caneth
Controller Area Network FD	CANFD	canfd
CANopen	CANOPEN	canopen
Control And Provisioning of Wireless Access Points - Control	CAPWAP-CONTROL	capwap
Control And Provisioning of Wireless Access Points - Data	CAPWAP-DATA	capwap.data
MIPv6 Option - Care-of Test	Care-of Test	mip6.options.cot
MIPv6 Option - Care-of Test Init	Care-of Test Init	mip6.options.coti
Common Address Redundancy Protocol	CARP	carp
Cast Client Control Protocol	CAST	cast
ETSI Card Application Toolkit Transport Protocol	CAT-TP	cattp
Concise Binary Object Representation	CBOR	cbor
Citizen Broadband Radio Service - Object Identifiers	CBRS_OIDS	cbrs_oids
3GPP/GSM Cell Broadcast Service Protocol	cbsp	cbsp
TCP Option - CC	CC	tcp.options.cc
TCP Option - CC.ECHO	CC.ECHO	tcp.options.ccecho
TCP Option - CC.NEW	CC.NEW	tcp.options.ccnew
CCSDS	CCSDS	ccsds
H.324/CCSRL	CCSRL	ccsrl
WiMax CDMA Code Attribute	CDMA Code Attribute	wmx.cdma
CDMA2K	CDMA2K	cdma2k
Cisco Discovery Protocol	CDP	cdp
CDS Clerk Server Calls	CDS_CLERK	cds_clerkserver
DCE/RPC CDS Solicitation	cds_solicit	cds_solicit
Compressed Data Type	CDT	cdt
CELERRA_VNX	celerra_vnx	nfs.celerra_vnx
Common External Message Interface	cEMI	cemi
Ceph	Ceph	ceph
Circuit Emulation Service over Ethernet	CESoETH	cesoeth
CESoPSN basic NxDS0 mode (no RTP support)	CESoPSN basic (no RTP)	pwcesopsn
CFDP	CFDP	cfdp
Cisco NetFlow/IPFIX	CFLOW	cflow
CFM EOAM 802.1ag/ITU Protocol	CFM	cfm
Cisco FabricPath	CFP	cfp
MIPv6 Option - CGA Parameters	CGA Parameters	mip6.options.cgar
MIPv6 Option - CGA Parameters Request	CGA Parameters Request	mip6.options.cgapr
Cisco Group Management Protocol	CGMP	cgmp
Character Generator Protocol	Chargen	chargen
Charging ASE	ChargingASE	chargingase
Cisco HDLC	CHDLC	chdlc
Common Image Generator Interface	CIGI	cigi
Computer Interface to Message Distribution	CIMD	cimd
Cimetrics MS/TP	Cimetrics MS/TP	cimetrics
Common Industrial Protocol	CIP	cip
Common Industrial Protocol, I/O Class 1	CIP Class 1	cipio1
Common Industrial Protocol, I/O	CIP I/O	cipio
Common Industrial Protocol, Motion	CIP Motion	cipm
Common Industrial Protocol, Motion - Rev 3	CIP Motion - Rev 3	cipm3
Common Industrial Protocol, Safety	CIP Safety	cipsafety
Common Industrial Protocol, Safety - Base - Data	CIP Safety - Base - Data	cipsafety_bd
Common Industrial Protocol, Safety - Base - Time Coordination	CIP Safety - Base - Time Coordination	cipsafety_bt
Common Industrial Protocol, Safety - Extended - Data	CIP Safety - Extended - Data	cipsafety_ed
Common Industrial Protocol, Safety - Extended - Time Coordination	CIP Safety - Extended - Time Coordination	cipsafety_et
CIP Connection Configuration Object	CIPCCO	cipcco
CIP Class Generic	CIPCLS	cipcls
CIP Connection Manager	CIPCM	cipcm
CIP Modbus Object	CIPMB	cipmb
CIP PCCC Object	CIPPCCC	cippccc
CIP Safety Supervisor	CIPSSupervisor	cipssupervisor
CIP Safety Validator	CIPSValidator	cipsvalidator
Cisco MetaData	Cisco MetaData	cmd
Cisco ttag	Cisco ttag	ttag
CISCO ERSPAN3 Marker Packet	CISCO3 ERSPAN MARKER	cisco-erspan3-marker
CableLabs Layer 3 Protocol	CL3	cl3
CableLabs Dual-Channel Wi-Fi	cl3dcw	cl3dcw
ISO 10035-1 OSI Connectionless Association Control Service	CLACSE	clacse
Simple Traversal of UDP Through NAT	CLASSICSTUN	classicstun
Connectionless Lightweight Directory Access Protocol	CLDAP	cldap
Clearcase NFS	CLEARCASE	clearcase
Classical IP frame	CLIP	clip
Clique Reliable Multicast Protocol	Clique-rm	clique-rm
ISO 8473/X.233 CLNP ConnectionLess Network Protocol	CLNP	clnp
ISO 9576-1 OSI Connectionless Presentation Protocol	CLPRES	clpres
ISO 9548-1 OSI Connectionless Session Protocol	CLSP	clsp
ISO 8602/X.234 CLTP ConnectionLess Transport Protocol	CLTP	cltp
Failover Cluster Management API (clusapi)	CLUSAPI	clusapi
X711 CMIP	CMIP	cmip
Certificate Management Protocol	CMP	cmp
China Mobile Point to Point Protocol	CMPP	cmpp
Cryptographic Message Syntax	CMS	cms
Component Network over IP	CN/IP	cnip
Constrained Application Protocol	CoAP	coap
collectd network data	collectd	collectd
IP Option - Commercial Security	Commercial Security	ip.options.cipso
Community ID Flow Hashing	CommunityID	communityid
IPv6 Routing Types - Compact Routing	Compact Routing	ipv6.routing.type.crh
Component Status Protocol	ComponentStatusProtocol	componentstatusprotocol
Compound Frames (Deprecated)	Compound Frames (Deprecated)	lcp.opt.compound_frames
Consistent Overhead Byte Stuffing (COBS)	Consistent Overhead Byte Stuffing (COBS)	lcp.opt.cobs
MIPv6 Option - Context Request	Context Request	mip6.options.cr
DCE/RPC Conversation Manager	CONV	conv
Common Open Policy Service	COPS	cops
Totemnet Layer of Corosync Cluster Engine	COROSYNC/TOTEMNET	corosync_totemnet
Totem Single Ring Protocol implemented in Corosync Cluster Engine	COROSYNC/TOTEMSRP	corosync_totemsrp
CBOR Object Signing and Encryption	COSE	cose
Coseventcomm Dissector Using GIOP API	COSEVENTCOMM	giop-coseventcomm
CoSine IPNOS L2 debug output	CoSine	cosine
Cosnaming Dissector Using GIOP API	COSNAMING	giop-cosnaming
ISO 8073/X.224 COTP Connection-Oriented Transport Protocol	COTP	cotp
Couchbase Protocol	Couchbase	couchbase
CP2179 Protocol	CP2179	cp2179
Cross Point Frame Injector	CPFI	cpfi
Check Point High Availability Protocol	CPHA	cpha
ITS message - CPM	CPM	its.message.cpm
DNS Control Program Server	cprpc_server	cprpc_server
Cassandra CQL Protocol	CQL	cql
Credential Security Support Provider	CredSSP	credssp
Clock Reference Format	CRF	crf
Certificate Request Message Format	CRMF	crmf
CRTP	CRTP	crtp
CRTP (CNTCP)	CRTP (CNTCP)	crtp_cntcp
CRTP (CS)	CRTP (CS)	crtp_cs
CRTP (CUDP 16)	CRTP (CUDP 16)	crtp_cudp16
CRTP (CUDP 8)	CRTP (CUDP 8)	crtp_cudp8
CSM_ENCAPS	CSM_ENCAPS	csm_encaps
CSN.1	CSN1	csn1
Cluster TDB	CTDB	ctdb
Common Unix Printing System (CUPS) Browsing Protocol	CUPS	cups
AVTP Compressed Video Format	CVF	cvf
CVS pserver	cvspserver	cvspserver
Cisco Wireless IDS Captures	CWIDS	cwids
D-Bus	D-Bus	dbus
Digital Audio Access Protocol	DAAP	daap
X.519 Directory Access Protocol	DAP	dap
Data	Data	data
Daytime Protocol	DAYTIME	daytime
Dropbox LAN sync Protocol	DB-LSP	db-lsp
Dropbox LAN sync Discovery Protocol	DB-LSP-DISC	db-lsp-disc
Dublin Core Metadata (DC)	dc	dc
dCache	dcache	nfs.dcache
Distributed Checksum Clearinghouse protocol	DCC	dcc
Datagram Congestion Control Protocol	DCCP	dccp
DCE Identifier	DCE Identifier	lcp.opt.dce_identifier
DCE/RPC UpServer	dce_update	dce_update
Distributed Computing Environment / Remote Procedure Call (DCE/RPC)	DCERPC	dcerpc
DCOM	DCOM	dcom
ETSI Distribution & Communication Protocol (for DRM)	DCP (ETSI)	dcp-etsi
DCP Application Framing Layer	DCP-AF	dcp-af
DCP Protection, Fragmentation & Transport Layer	DCP-PFT	dcp-pft
DCP Tag Packet Layer	DCP-TPL	dcp-tpl
Catapult DCT2000 packet	DCT2000	dct2000
Datagram Delivery Protocol	DDP	ddp
Dynamic DNS Tools Protocol	DDTP	ddtp
DEC DNA Routing Protocol	DEC_DNA	dec_dna
DEC Spanning Tree Protocol	DEC_STP	dec_stp
DECT Protocol	DECT	dect
Default Protocol ID	Default Protocol ID	pppmuxcp.opt.def_pid
Deflate	Deflate	ccp.opt.deflate
MIPv6 Option - Delegated Mobile Network Prefix	Delegated Mobile Network Prefix	mip6.options.dmnp
ITS message - DENM	DENM	its.message.denm
ITS message - DENMv1	DENMv1	its.message.denmv1
DeviceNet Protocol	DeviceNet	devicenet
Dynamic Host Configuration Protocol	DHCP/BOOTP	dhcp
DHCP Failover	DHCPFO	dhcpfo
DHCPv6	DHCPv6	dhcpv6
DHCPv6 Bulk Leasequery	DHCPv6 Bulk Leasequery	dhcpv6.bulk_leasequery
Diameter Protocol	Diameter	diameter
Diameter 3GPP	Diameter3GPP	diameter.3gpp
DICOM	DICOM	dicom
Distributed Interactive Simulation	DIS	dis
X.519 Directory Information Shadowing Protocol	DISP	disp
Distcc Distributed Compiler	DISTCC	distcc
DJI UAV Drone Control Protocol	DJIUAV	djiuav
Dynamic Link Exchange Protocol	DLEP	dlep
Distributed Lock Manager	DLM3	dlm3
Device Level Ring	DLR	dlr
Data Link SWitching	DLSw	dlsw
Diagnostic Log and Trace (DLT)	DLT	dlt
DLT User	DLT_USER	user_dlt
Direct Message Profile	DMP	dmp
DMX	DMX	dmx
DMX Channels	DMX Channels	dmx_chan
DMX SIP	DMX SIP	dmx_sip
DMX Test Frame	DMX Test Frame	dmx_test
DMX Text Frame	DMX Text Frame	dmx_text
Distributed Network Protocol 3.0	DNP 3.0	dnp3
Domain Name System	DNS	dns
MIPv6 Option - DNS-UPDATE-TYPE	DNS-UPDATE-TYPE	mip6.options.dnsu
DNS Server	DNSSERVER	dnsserver
DOCSIS	DOCSIS	docsis
DOCSIS Bonded Initial Ranging Message	DOCSIS B-INT-RNG-REQ	docsis_bintrngreq
DOCSIS Baseline Privacy Key Management Request	DOCSIS BPKM-REQ	docsis_bpkm.req
DOCSIS Baseline Privacy Key Management Response	DOCSIS BPKM-RSP	docsis_bpkm.rsp
DOCSIS CM Control Request	DOCSIS CM-CTRL-REQ	docsis_cmctrl.req
DOCSIS CM Control Response	DOCSIS CM-CTRL-RSP	docsis_cmctrlrsp
DOCSIS CM-STATUS Report	DOCSIS CM-STATUS	docsis_cmstatus
DOCSIS Status Report Acknowledge	DOCSIS CM-STATUS-ACK	docsis_cmstatusack
DOCSIS Dynamic Bonding Change Acknowledge	DOCSIS DBC-ACK	docsis_dbcack
DOCSIS Dynamic Bonding Change Request	DOCSIS DBC-REQ	docsis_dbcreq
DOCSIS Dynamic Bonding Change Response	DOCSIS DBC-RSP	docsis_dbcrsp
DOCSIS Downstream Channel Change Acknowledge	DOCSIS DCC-ACK	docsis_dccack
DOCSIS Downstream Channel Change Request	DOCSIS DCC-REQ	docsis_dccreq
DOCSIS Downstream Channel Change Response	DOCSIS DCC-RSP	docsis_dccrsp
DOCSIS Downstream Channel Descriptor	DOCSIS DCD	docsis_dcd
DOCSIS Downstream Profile Descriptor	DOCSIS DPD	docsis_dpd
DOCSIS Path Verify Request	DOCSIS DPV-REQ	docsis_dpv.req
DOCSIS Path Verify Response	DOCSIS DPV-RSP	docsis_dpv.rsp
DOCSIS Dynamic Service Addition Acknowledge	DOCSIS DSA-ACK	docsis_dsaack
DOCSIS Dynamic Service Addition Request	DOCSIS DSA-REQ	docsis_dsareq
DOCSIS Dynamic Service Addition Response	DOCSIS DSA-RSP	docsis_dsarsp
DOCSIS Dynamic Service Change Acknowledge	DOCSIS DSC-ACK	docsis_dscack
DOCSIS Dynamic Service Change Request	DOCSIS DSC-REQ	docsis_dscreq
DOCSIS Dynamic Service Change Response	DOCSIS DSC-RSP	docsis_dscrsp
DOCSIS Dynamic Service Delete Request	DOCSIS DSD-REQ	docsis_dsdreq
DOCSIS Dynamic Service Delete Response	DOCSIS DSD-RSP	docsis_dsdrsp
DOCSIS Energy Management Request	DOCSIS EM-REQ	docsis_emreq
DOCSIS Energy Management Response	DOCSIS EM-RSP	docsis_emrsp
DOCSIS Initial Ranging Message	DOCSIS INT-RNG-REQ	docsis_intrngreq
DOCSIS MAC Management	DOCSIS MAC MGMT	docsis_mgmt
DOCSIS Upstream Bandwidth Allocation - version 5	DOCSIS MAP	docsis_map
DOCSIS Upstream Bandwidth Allocation - version 1	DOCSIS MAP	docsis_map
DOCSIS MAC Domain Description	DOCSIS MDD	docsis_mdd
DOCSIS OFDM Channel Descriptor	DOCSIS OCD	docsis_ocd
OFDM Downstream Profile Test Acknowledge	DOCSIS OPT-ACK	docsis_optack
OFDM Downstream Profile Test Request	DOCSIS OPT-REQ	docsis_optreq
OFDM Downstream Profile Test Response	DOCSIS OPT-RSP	docsis_optrsp
DOCSIS PHY Link Channel	DOCSIS PLC	docsis_plc
DOCSIS Resource Block Assignment Message	DOCSIS RBA	docsis_rba
DOCSIS Registration Acknowledge	DOCSIS REG-ACK	docsis_regack
DOCSIS Registration Requests	DOCSIS REG-REQ	docsis_regreq
DOCSIS Registration Request Multipart	DOCSIS Reg-Req-Mp	docsis_regreqmp
DOCSIS Registration Responses	DOCSIS REG-RSP	docsis_regrsp
DOCSIS Registration Response Multipart	DOCSIS Reg-Rsp-Mp	docsis_regrspmp
DOCSIS Range Request Message	DOCSIS RNG-REQ	docsis_rngreq
DOCSIS Ranging Response	DOCSIS RNG-RSP	docsis_rngrsp
DOCSIS Segment	DOCSIS Segment	docsis_segment
DOCSIS Appendix C TLVs	DOCSIS TLVs	docsis_tlv
DOCSIS Upstream Channel Descriptor Type 29	DOCSIS type29ucd	docsis_type29ucd
DOCSIS Upstream Channel Descriptor Type 35	DOCSIS type35ucd	docsis_type35ucd
DOCSIS Upstream Channel Descriptor Type 51	DOCSIS type51ucd	docsis_type51ucd
DOCSIS Upstream Channel Change Request	DOCSIS UCC-REQ	docsis_uccreq
DOCSIS Upstream Channel Change Response	DOCSIS UCC-RSP	docsis_uccrsp
DOCSIS Upstream Channel Descriptor	DOCSIS UCD	docsis_ucd
DOCSIS Vendor Specific Encodings	DOCSIS VSIF	docsis_vsif
DOCSIS_INIT_RANGING	DOCSIS_INIT_RANGING	docsis_init_ranging
DOCSIS_NCP	DOCSIS_NCP	docsis_ncp
DOF Protocol Stack	DOF	dof
DOF Protocol Stack TCP	DOF-TCP	dof-tcp
DOF Protocol Stack UDP	DOF-UDP	dof-udp
DOF CCM Security Mode of Operation	DOF.CCM	dof.ccm
DOF CCM Security Mode App	DOF.CCM.APP	dof.ccm.app
DOF CCM Security Mode DSP Options	DOF.CCM.DSP	dof.ccm.dsp
DOF Network Protocol V1	DOF.DNP.V1	dof.dnp.v1
DOF Session Protocol	DOF.ESP	dof.esp
DOF Object Access Protocol	DOF.OAP	dof.oap
DOF Object Access Protocol DSP Options	DOF.OAP.DSP	dof.oap.dsp
DOF Secure Group Management Protocol	DOF.SGMP	dof.sgmp
DOF Ticket Exchange Protocol Version 1	DOF.TEP1	dof.tep1
DOF Ticket Exchange Protocol DSP Options	DOF.TEP1.DSP	dof.tep1.dsp
DOF Ticket Request Protocol	DOF.TRP	dof.trp
DOF Ticket Request Protocol DSP Options	DOF.TRP.DSP	dof.trp.dsp
DoIP (ISO13400) Protocol	DoIP	doip
X.501 Directory Operational Binding Management Protocol	DOP	dop
DisplayPort AUX-Channel	DPAUX	dpaux
DPAUXMON DisplayPort AUX channel monitor	DPAUXMON	dpauxmon
DirectPlay Protocol	DPLAY	dplay
DirectPlay 8 protocol	DPNET	dpnet
Digital Private Signalling System No 1	DPNSS	dpnss
Digital Private Signalling System No 1 Link Layer	DPNSS Link	dpnss_link
DOF Application Protocol	DPS.APP	dof.app
DOF Network Protocol	DPS.DNP	dof.dnp
DOF Network Protocol V0	DPS.DNP.V0	dof.dnp.v0
DOF Presentation Protocol	DPS.DPP	dof.dpp
DOF Presentation Protocol V0	DPS.DPP.V0	dof.dpp.v0
DOF Presentation Protocol V2	DPS.DPP.V2	dof.dpp.v2
DOF Presentation Protocol V2 Support	DPS.DPP.V2S	dof.dpp.v2s
DOF Object Identifier	DPS.OID	dof.oid
Distributed Ruby	DRb	drb
DRBD Protocol	DRBD	drbd
DRDA	DRDA	drda
RDP Dynamic Channel Protocol	DRDYNVC	rdp_drdynvc
DRSUAPI	DRSUAPI	drsuapi
UAVCAN DSDL	DSDL	uavcan_dsdl
Data Stream Interface	DSI	dsi
X.519 Directory System Protocol	DSP	dsp
Dynamic Source Routing	DSR	dsr
Active Directory Setup	DSSETUP	dssetup
Digital Transmission Content Protection over IP	DTCP-IP	dtcp-ip
Datagram Transport Layer Security	DTLS	dtls
Dynamic Trunk Protocol	DTP	dtp
DOF Tunnel Protocol Stack	DTPS	dtps
DeskTop PassThrough Protocol	DTPT	dtpt
DCE Distributed Time Service Provider	DTSPROVIDER	dtsprovider
DCE Distributed Time Service Local Server	DTSSTIME_REQ	dtsstime_req
DPNSS/DASS2-User Adaptation Layer	DUA	dua
DVB Application Information Table	DVB AIT	dvb_ait
DVB Bouquet Association Table	DVB BAT	dvb_bat
DVB Event Information Table	DVB EIT	dvb_eit
DVB Network Information Table	DVB NIT	dvb_nit
DVB Service Description Table	DVB SDT	dvb_sdt
DVB Time and Date Table	DVB TDT	dvb_tdt
DVB Time Offset Table	DVB TOT	dvb_tot
DVB Common Interface	DVB-CI	dvb-ci
DVB-DATA MultiProtocol Encapsulation	DVB-DATA MPE	dvb_data_mpe
DVB-S2 Mode Adaptation Header	DVB-S2	dvb-s2_modeadapt
DVB-S2 Baseband Frame	DVB-S2-BB	dvb-s2_bb
DVB-S2 GSE Packet	DVB-S2-GSE	dvb-s2_gse
DVB-S2 Signalization Table	DVB-S2-TABLE	dvb-s2_table
Distance Vector Multicast Routing Protocol	DVMRP	dvmrp
DX cluster	DX	dx
Data Exchange Layer	DXL	dxl
Ethernet Local Management Interface	E-LMI	elmi
ITU-T E.164 number	E.164	e164
ITU-T E.212 number	E.212	e212
E100 Encapsulation	E100	e100
E1 Application Protocol	E1AP	e1ap
E2 Application Protocol	E2AP	e2ap
Extensible Authentication Protocol	EAP	eap
802.1X Authentication	EAPOL	eapol
MACsec Key Agreement	EAPOL-MKA	mka
EBHSCR Protocol	EBHSCR	ebhscr
EtherCAT datagram(s)	ECAT	ecat
EtherCAT Mailbox Protocol	ECAT_MAILBOX	ecat_mailbox
TCP Option - Echo	Echo	tcp.options.echo
Echo	ECHO	echo
TCP Option - Echo reply	Echo reply	tcp.options.echoreply
ECMP	ECMP	ecmp
ECP Protocol	ECP	ecp
Edge Control Protocol	ECP21	ecp21
evolved Common Public Radio Interface	eCPRI	ecpri
eDonkey Protocol	EDONKEY	edonkey
Extreme Discovery Protocol	EDP	edp
EERO Protocol	EERO	eero
EFS (pidl)	EFS	efs
Ethernet Global Data	EGD	egd
RDP Graphic pipeline channel Protocol	EGFX	rdp_egfx
EHS	EHS	ehs
Enhanced Interior Gateway Routing Protocol	EIGRP	eigrp
Elasticsearch	Elasticsearch	elasticsearch
ELCOM Communication Protocol	ELCOM	elcom
Executable and Linkable Format	ELF	elf
OpenBSD Encapsulating device	ENC	enc
TCP Option - End of Option List (EOL)	End of Option List (EOL)	tcp.options.eol
IP Option - End of Options List (EOL)	End of Options List (EOL)	ip.options.eol
Enhanced RTP compression (RFC3545)	Enhanced RTP compression (RFC3545)	ipcp.opt.iphc.enhanced_rtp_compress
EtherNet/IP (Industrial Protocol)	ENIP	enip
Endpoint Handlespace Redundancy Protocol	ENRP	enrp
ENTTEC	ENTTEC	enttec
Ethernet POWERLINK	EPL	epl
ETHERNET Powerlink V1.0	EPL_V1	epl_v1
DCE/RPC Endpoint Mapper	EPM	epm
Erlang Port Mapper Daemon	EPMD	epmd
DCE/RPC Endpoint Mapper v4	EPMv4	epm4
IEEE 802.3 EPON Preamble	EPON	epon
Extensible Record Format	ERF	erf
GSM A-bis P-GSL	Ericsson GSM A-bis P-GSL	gsm_abis_pgsl
GSM A-bis TFP	Ericsson GSM A-bis TFP	gsm_abis_tfp
Ericsson HDLC	Ericsson HDLC as used in A-bis over IP	ehdlc
Ericsson A-bis OML	Ericsson OML	gsm_abis_om2000
Erlang Distribution Protocol	ErlDP	erldp
Error Code	Error Code	vsncp.opt.errorcode
Encapsulated Remote Switch Packet ANalysis	ERSPAN	erspan
ETSI IPDC Bootstrap	ESG Bootstrap	dvb_ipdc
SAIA Ether-S-I/O protocol	ESIO	esio
ISO 9542 ESIS Routeing Information Exchange Protocol	ESIS	esis
EtherCAT Switch Link	ESL	esl
Encapsulating Security Payload	ESP	esp
Extended Security Services	ESS	ess
802.1BR E-Tag	ETAG	etag
Apache Etch Protocol	Etch	etch
EtherCAT frame header	ETHERCAT	ecatf
Ethernet over IP	ETHERIP	etherip
Ethernet	Ethernet	eth
OAMPDU	Ethernet OAM PDU	oampdu
Ethernet PW (CW heuristic)	Ethernet PW (CW heuristic)	pwethheuristic
Ethernet PW (no CW)	Ethernet PW (no CW)	pwethnocw
PW Ethernet Control Word	Ethernet PW (with CW)	pwethcw
Ethertype	Ethertype	ethertype
Card Application Toolkit ETSI TS 102.223	ETSI CAT	etsi_cat
ETV-AM DDB Section	ETV-AM DDB	etv-ddb
ETV-AM DII Section	ETV-AM DII	etv-dii
ETV-AM EISS Section	ETV-AM EISS	eiss
Event Tracing for Windows	ETW	etw
ETW Ndis	ETW Ndis	etw.ndis
ETW WFP Capture	ETW WFP Capture	etw.wfp_capture
ITS message - EVCSN	EVCSN	its.message.evcsn
Event Logger	EVENTLOG	eventlog
Enhanced Variable Rate Codec	EVRC	evrc
Enhanced Variable Rate Codec (Legacy Encapsulation)	EVRC (Legacy)	evrc_legacy
Enhanced Variable Rate Codec B	EVRC-B	evrcb
Enhanced Variable Rate Codec - Narrowband-Wideband	EVRC-NW	evrcnw
Enhanced Variable Rate Codec - Narrowband-Wideband plus 2kpbs	EVRC-NW2K	evrcnw2k
Enhanced Variable Rate Codec - Wideband	EVRC-WB	evrcwb
ITS message - EVRSR	EVRSR	its.message.evrsr
Enhanced Voice Services	EVS	evs
Exablaze trailer	Exablaze	exablaze
Remote Process Execution	EXEC	exec
EXtreme extra Eth Header	EXEH	exeh
TCP Option - Experimental	Experimental	tcp.options.experimental
MIPv6 Option - Experimental	Experimental	mip6.options.em
EXPORTED_PDU	exported_pdu	exported_pdu
IP Option - Extended Security	Extended Security	ip.options.ext_security
F1 Application Protocol	F1AP	f1ap
F5 Ethernet Trailer Protocol	F5 Ethernet trailer	f5ethtrailer
F5 Ethernet Trailer Protocol - TLS Provider	F5 TLS	f5ethtrailer.tls
Favored-Peer	Favored-Peer	bacp.opt.favored_peer
Firebird SQL Database Remote Protocol	FB/IB GDS DB	gdsdb
(Facebook) Zero Protocol	FBZERO	fb_zero
Fibre Channel	FC	fc
FC Extended Link Svc	FC ELS	fcels
Fibre Channel Fabric Zone Server	FC FZS	fcfzs
Fibre Channel Name Server	FC-dNS	fcdns
FC Fabric Configuration Server	FC-FCS	fcs
Fibre Channel Single Byte Command	FC-SB3	fcsb3
Fibre Channel Security Protocol	FC-SP	fcsp
Fibre Channel SW_ILS	FC-SWILS	swils
Fc00 CryptoAuth	Fc00	fc00
Fibre Channel Common Transport	FC_CT	fcct
FastCGI	FCGI	fcgi
Fibre Channel over Ethernet	FCoE	fcoe
Fibre Channel over Infiniband	FCoIB	fcoib
Fibre Channel Protocol for SCSI	FCP	fcp
FCS Alternatives	FCS Alternatives	lcp.opt.fcs_alternatives_bytes
Fibre Channel Delimiters	FCSoF	fcsof
Fiber Distributed Data Interface	FDDI	fddi
Foundry Discovery Protocol	FDP	fdp
Far End Failure Detection	FEFD	fefd
Sony FeliCa	FeliCa	felica
FOUNDATION Fieldbus	FF	ff
FCIP	Fibre Channel over IP	fcip
File	File	file
BLF File Format	File-BLF	file-blf
PCAP File Format	File-PCAP	file-pcap
PCAPNG File Format	File-PCAPNG	file-pcapng
DCE DFS File Exporter	FILEEXP	fileexp
F5 Capture Information	FILEINFO	f5fileinfo
Find Identification of Network Devices	FIND	find
finger	FINGER	finger
FCoE Initialization Protocol	FIP	fip
Financial Information eXchange Protocol	FIX	fix
DCE DFS Fileset Location Server	FLDB	fldb
FlexNet	FLEXNET	flexnet
FlexRay Protocol	FLEXRAY	flexray
NSN FLIP	FLIP	flip
File Mapping Protocol	FMP	fmp
File Mapping Protocol Notify	FMP/NOTIFY	fmp_notify
Flight Message Transfer Protocol (FMTP)	FMTP	fmtp
Forwarding and Control Element Separation Protocol	ForCES	forces
Fortinet Single Sign On	fortinet_sso	fortinet_sso
FP	FP	fp
FP Hint	FP Hint	fp_hint
Huawei FP Multiplexing Header	FP Mux	fp_mux
Frame Relay	FR	fr
Fractal Generator Protocol	FractalGeneratorProtocol	fractalgeneratorprotocol
Frame	Frame	frame
IEEE 802.3br Frame Preemption Protocol	Frame Preemption Protocol	fpp
PW Frame Relay DLCI Control Word	Frame Relay DLCI PW	pwfr
Microsoft File Replication Service API	FRSAPI	frsapi
File Replication Service	FRSRPC	frsrpc
File Replication Service DFS-R	FRSTRANS	frstrans
File Server Remote VSS Protocol	FSRVP	fsrvp
ISO 8571 FTAM	FTAM	ftam
FTDI FT USB	FTDI FT	ftdi-ft
FTDI Multi-Protocol Synchronous Serial Engine	FTDI MPSSE	ftdi-mpsse
File Transfer Protocol (FTP)	FTP	ftp
FTP Data	FTP-DATA	ftp-data
FTServer Operations	FTSERVER	ftserver
Checkpoint FW-1	FW-1	fw1
G.723	G.723	g723
Gadu-Gadu Protocol	Gadu-Gadu	gadu-gadu
Gandalf FZA	Gandalf FZA	ccp.opt.gfza
GBCS GBZ	GBCS GBZ	gbcs_gbz
GBCS Message	GBCS Message	gbcs_message
GBCS Tunnel	GBCS Tunnel	gbcs_tunnel
GCSNA	GCSNA	gcsna
GDB Remote Serial Protocol	GDB remote	gdb
Gearman Protocol	Gearman	gearman
Cisco GED-125 Protocol	GED125	ged125
Graylog Extended Log Format	GELF	gelf
PW MPLS Control Word (generic/preferred)	Generic PW (with CW)	pwmcw
Generic Network Virtualization Encapsulation	Geneve	geneve
Linux Generic Netlink protocol	genl	genl
Generic Framing Procedure	GFP	gfp
Gias Dissector Using GIOP API	GIAS	giop-gias
Compuserve GIF	GIF image	image-gif
giFT Internet File Transfer	giFT	gift
General Inter-ORB Protocol	GIOP	giop
Git Smart Protocol	Git	git
Gateway Load Balancing Protocol	GLBP	glbp
Glow	GLOW	glow
GLUSTER	gluster	nfs.gluster
Gluster CLI	Gluster CLI	gluster.cli
Gluster Dump	Gluster Dump	gluster.dump
Gluster Portmap	Gluster Portmap	gluster.pmap
Gluster Daemon	GlusterD	glusterd
Gluster Daemon Brick Operations	GlusterD Brick	glusterd.brick
Gluster Daemon Friend Operations	GlusterD Friend	glusterd.friend
Gluster Daemon Management	GlusterD Management	glusterd.mgmt
GlusterFS	GlusterFS	glusterfs
GlusterFS Callback	GlusterFS Callback	glusterfs.cbk
GlusterFS Handshake	GlusterFS Handshake	glusterfs.hndsk
Gigamon Header	GMHDR	gmhdr
GEO-Mobile Radio (1) BCCH	GMR-1 BCCH	gmr1.bcch
GEO-Mobile Radio (1) CCCH	GMR-1 CCCH	gmr1.ccch
GEO-Mobile Radio (1) Common	GMR-1 Common	gmr1.common
GEO-Mobile Radio (1) DTAP	GMR-1 DTAP	gmr1.dtap
GEO-Mobile Radio (1) RACH	GMR-1 RACH	gmr1.rach
GEO-Mobile Radio (1) RR	GMR-1 RR	gmr1.rr
GARP Multicast Registration Protocol	GMRP	gmrp
Gigamon Trailer	GMTRAILER	gmtrailer
Gnutella Protocol	GNUTELLA	gnutella
GeoNetworking	GNW	gnw
Google/Apple Exposure Notification	Google/Apple Exposure Notification	bluetooth.gaen
GOOSE	GOOSE	goose
Gopher	Gopher	gopher
GPEF	GPEF	gpef
Logical Link Control GPRS	GPRS-LLC	llcgprs
GPRS Network Service	GPRS-NS	gprs-ns
GPRS CDR	GPRSCDR	gprscdr
GQUIC (Google Quick UDP Internet Connections)	GQUIC	gquic
Generic Routing Encapsulation	GRE	gre
MIPv6 Option - GRE Key	GRE Key	mip6.options.grek
GRPC Message	GRPC	grpc
DG Gryphon Protocol	Gryphon	gryphon
GSM A-I/F BSSMAP	GSM BSSMAP	gsm_a.bssmap
Lb-I/F BSSMAP LE	GSM BSSMAP LE	gsm_bssmap_le
GSM Cell Broadcast Channel	GSM CBCH	gsm_cbch
GSM CCCH	GSM CCCH	gsm_a.ccch
GSM Cell Broadcast Service	GSM Cell Broadcast Service	gsm_cbs
GSM A-I/F COMMON	GSM COMMON	gsm_a
GSM A-I/F DTAP	GSM DTAP	gsm_a.dtap
GSM EC-CCCH	GSM EC-CCCH	gsm_a.ec_ccch
GSM A-I/F GPRS Mobility and Session Management	GSM Management	gsm_a.gm
GSM multiplexing for AMR	GSM Osmux	osmux
GSM over IP protocol as used by ip.access	GSM over IP	gsm_ipa
Radio Link Control, Medium Access Control, 3GPP TS44.060	GSM RLC MAC	gsm_rlcmac
GSM A-I/F RP	GSM RP	gsm_a.rp
GSM A-I/F Radio Resource Management	GSM RR	gsm_a.rr
GSM SACCH	GSM SACCH	gsm_a.sacch
GSM SIM 11.11	GSM SIM	gsm_sim
GSM SMS TPDU (GSM 03.40)	GSM SMS	gsm_sms
GSM Short Message Service User Data	GSM SMS UD	gsm_sms_ud
GSM Um Interface	GSM Um	gsm_um
GSM-R User-to-User Signaling	GSM-R	gsm-r-uus1
GSM Mobile Application	GSM_MAP	gsm_map
GSM Radiotap	GSMTAP	gsmtap
GSMTAP libosmocore logging	GSMTAP-LOG	gsmtap_log
GSS-API Generic Security Service Application Program Interface	GSS-API	gss-api
Osmocom General Subscriber Update Protocol	GSUP	gsup
GPRS Tunneling Protocol	GTP	gtp
GPRS Tunneling Protocol Prime	GTP (Prime)	gtpprime
GPRS Tunneling Protocol V2	GTPv2	gtpv2
GigE Vision Control Protocol	GVCP	gvcp
GARP VLAN Registration Protocol	GVRP	gvrp
GigE Vision Streaming Protocol	GVSP	gvsp
ITU-T Recommendation H.223	H.223	h223
ITU-T Recommendation H.223 (Bitswapped)	H.223 (Bitswapped)	h223_bitswapped
H.225 RAS	H.225 RAS	h225_ras
H323-MESSAGES	H.225.0	h225
H235-SECURITY-MESSAGES	H.235	h235
MULTIMEDIA-SYSTEM-CONTROL	H.245	h245
ITU-T Recommendation H.261	H.261	h261
ITU-T Recommendation H.263	H.263	h263
H.263 RTP Payload header (RFC2190)	H.263 (RFC2190)	rfc2190
ITU-T Recommendation H.263 RTP Payload header (RFC4629)	H.263P	h263p
H.264	H.264	h264
H.265	H.265	h265
H.323	H.323	h323
H.450 Supplementary Services	H.450	h450
H.460 Supplementary Services	H.460	h460
H.501 Mobility	H.501	h501
Sinec H1 Protocol	H1	h1
H221NonStandard	h221nonstd	h221nonstd
H.248 MEGACO	H248	h248
H.248 3GPP	H2483GPP	h248.3gpp
H.248.2	H248_2	h248.2
H.248.7	H248AN	h248.an
H.248 Annex C	H248C	h248.annexc
H.248.10	H248CHP	h248.chp
H.248 Annex E	H248E	h248e
H.248 Q.1950 Annex A	H248Q1950	h248q1950
H.450 Remote Operations Apdus	H450.ROS	h450.ros
MIPv6 Option - Handoff Indicator	Handoff Indicator	mip6.options.hi
HART_IP Protocol	HART_IP	hart_ip
Hazelcast Wire Protocol	HAZELCAST	hzlcst
Bluetooth Broadcom HCI	HCI BROADCOM	bthci_vendor.broadcom
Bluetooth Intel HCI	HCI Intel	bthci_vendor.intel
Bluetooth HCI ACL Packet	HCI_ACL	bthci_acl
Bluetooth HCI Command	HCI_CMD	bthci_cmd
Bluetooth HCI Event	HCI_EVT	bthci_evt
Bluetooth HCI H1	HCI_H1	hci_h1
Bluetooth HCI H4	HCI_H4	hci_h4
Bluetooth HCI ISO Packet	HCI_ISO	bthci_iso
Bluetooth Linux Monitor Transport	HCI_MON	hci_mon
Bluetooth HCI SCO Packet	HCI_SCO	bthci_sco
Bluetooth HCI USB Transport	HCI_USB	hci_usb
Hummingbird NFS Daemon	HCLNFSD	hclnfsd
Hotline Command-Response Transaction protocol	HCrt	hcrt
High bandwidth Digital Content Protection	HDCP	hdcp
High bandwidth Digital Content Protection version 2	HDCP2	hdcp2
HDFS Protocol	HDFS	hdfs
HDFSDATA Protocol	HDFSDATA	hdfsdata
HDLC-like framing for PPP	HDLC PW with PPP payload (no CW)	pw_hdlc_nocw_hdlc_ppp
HDLC PW, FR port mode (no CW)	HDLC PW, FR port mode (no CW)	pw_hdlc_nocw_fr
High-Definition Multimedia Interface	HDMI	hdmi
Hewlett-Packard PPC	Hewlett-Packard PPC	ccp.opt.hpppc
HI2Operations	HI2OPERATIONS	hi2operations
Host Identity Protocol	HIP	hip
HiPerConTracer Trace Service	HiPerConTracer	hipercontracer
Harman HiQnet	HiQnet	hiqnet
High-Speed LAN Instrument Protocol	HiSLIP	hislip
Health Level Seven	HL7	hl7
UTRAN Iuh interface HNBAP signalling	HNBAP	hnbap
MIPv6 Option - Home Network Prefix	Home Network Prefix	mip6.options.hnp
HomePlug protocol	HomePlug	homeplug
HomePlug AV protocol	HomePlug AV	homeplug-av
HomePNA, wlan link local tunnel	HomePNA	hpna
HP encapsulated remote mirroring	HP_ERM	hp_erm
HP Extended Local-Link Control	HPEXT	hpext
HPFEEDS HoneyPot Feeds Protocol	HPFEEDS	hpfeeds
HP Switch Protocol	HPSW	hpsw
HP NIC Teaming Heartbeat	HPTEAM	hpteam
High-speed SECS Message Service Protocol	HSMS	hsms
High-availability Seamless Redundancy (IEC62439 Part 3 Chapter 5)	HSR	hsr
HSR/PRP Supervision (IEC62439 Part 3)	HSR_PRP_SUPERVISION	hsr_prp_supervision
Cisco Hot Standby Router Protocol	HSRP	hsrp
Hypertext Transfer Protocol	HTTP	http
HyperText Transfer Protocol 2	HTTP2	http2
Hypertext Transfer Protocol Version 3	HTTP3	http3
HyperSCSI	HyperSCSI	hyperscsi
Inter-Integrated Circuit	I2C	i2c
I2C Data	I2C Data	i2c_data
I2C Events	I2C Events	i2c_event
Information Access Protocol	IAP	iap
Inter-Access-Point Protocol	IAPP	iapp
Inter-Asterisk eXchange v2	IAX2	iax2
InfiniBand	IB	infiniband
Apple iBeacon	iBeacon	ibeacon
iCall Communication Protocol	iCall	icall
Internet Content Adaptation Protocol	ICAP	icap
ICBAAccoCallback	ICBAAccoCB	cba_acco_cb
ICBAAccoCallback2	ICBAAccoCB2	cba_acco_cb2
ICBAAccoMgt	ICBAAccoMgt	cba_acco_mgt
ICBAAccoMgt2	ICBAAccoMgt2	cba_acco_mgt2
ICBAAccoServer	ICBAAccoServ	cba_acco_server
ICBAAccoServer2	ICBAAccoServ2	cba_acco_server2
ICBAAccoServerSRT	ICBAAccoServSRT	cba_acco_server_srt
ICBAAccoSync	ICBAAccoSync	cba_acco_sync
ICBABrowse	ICBABrowse	cba_browse
ICBABrowse2	ICBABrowse2	cba_browse2
ICBAGroupError	ICBAGErr	cba_grouperror
ICBAGroupErrorEvent	ICBAGErrEvent	cba_grouperror_event
ICBALogicalDevice	ICBALDev	cba_ldev
ICBALogicalDevice2	ICBALDev2	cba_ldev2
ICBAPhysicalDevice	ICBAPDev	cba_pdev
ICBAPhysicalDevice2	ICBAPDev2	cba_pdev2
ICBAPhysicalDevicePC	ICBAPDevPC	cba_pdev_pc
ICBAPhysicalDevicePCEvent	ICBAPDevPCEvent	cba_pdev_pc_event
ICBAPersist	ICBAPersist	cba_persist
ICBAPersist2	ICBAPersist2	cba_persist2
ICBARTAuto	ICBARTAuto	cba_rtauto
ICBARTAuto2	ICBARTAuto2	cba_rtauto2
ICBAState	ICBAState	cba_state
ICBAStateEvent	ICBAStateEvent	cba_state_event
ICBASystemProperties	ICBASysProp	cba_sysprop
ICBATime	ICBATime	cba_time
Internet Communications Engine Protocol	ICEP	icep
DCE DFS ICL RPC	ICL_RPC	icl_rpc
Internet Control Message Protocol	ICMP	icmp
Internet Control Message Protocol v6	ICMPv6	icmpv6
Internet Cache Protocol	ICP	icp
ICQ Protocol	ICQ	icq
DCOM IDispatch	IDispatch	dispatch
X.519 Internet Directly Mapped Protocol	IDMP	idmp
Ilda Digital Network Protocol	IDN	idn
Internetwork Datagram Protocol	IDP	idp
ISO/IEC 10747 (1993): Inter Domain Routing Protocol 	IDRP	idrp
IEC 60870-5-101	IEC 60870-5-101	iec60870_101
IEC 60870-5-101/104 ASDU	IEC 60870-5-101/104 ASDU	iec60870_asdu
IEC 60870-5-103	IEC 60870-5-103	iec60870_5_103
IEC 60870-5-104	IEC 60870-5-104	iec60870_104
IEC 61883 Protocol	IEC 61883	iec61883
IEEE 802 Tagged Frame	IEEE 802 Tagged Frame	bcp_ncp.opt.ieee_802_tagged_frame
IEEE 802.11 wireless LAN	IEEE 802.11	wlan
IEEE 802.11 wireless LAN (Centrino)	IEEE 802.11 (Centrino)	wlan_centrino
IEEE 802.11 wireless LAN aggregate frame	IEEE 802.11 Aggregate Data	wlan_aggregate
IEEE 802.11 wireless LAN extension frame	IEEE 802.11 EXT	wlan_ext
IEEE 802.15.4 Low-Rate Wireless PAN	IEEE 802.15.4	wpan
IEEE 802.15.4 Low-Rate Wireless PAN non-ASK PHY	IEEE 802.15.4 non-ASK PHY	wpan-nonask-phy
IEEE 802.15.4 Low-Rate Wireless PAN TAP	IEEE 802.15.4 TAP	wpan-tap
IEEE 802.1ad	IEEE 802.1AD	ieee8021ad
IEEE 802.1ah	IEEE 802.1AH	ieee8021ah
IEEE1609dot2	IEEE1609dot2	ieee1609dot2
IEEE 1722 Audio Video Transport Protocol (AVTP)	IEEE1722	ieee1722
IEEE 1722.1 Protocol	IEEE1722.1	ieee17221
IEEE 1905.1a	ieee1905	ieee1905
IEEE802a OUI Extended Ethertype	IEEE802a	ieee802a
iFCP	iFCP	ifcp
Internet Group membership Authentication Protocol	IGAP	igap
Internet Group Management Protocol	IGMP	igmp
Cisco Interior Gateway Routing Protocol	IGRP	igrp
ILMI	ILMI	ilmi
OMA Internal Location Protocol	ILP	ilp
Internet Message Access Protocol	IMAP	imap
Internet Message Format	IMF	imf
Intelligent Network Application Protocol	INAP	inap
InfiniBand Link	InfiniBand Link	infiniband_link
Infiniband Sockets Direct Protocol	Infiniband SDP	infiniband_sdp
Init shutdown service	INITSHUTDOWN	initshutdown
Interface Identifier	Interface Identifier	ipv6cp.opt.interface_identifier
Interlink Protocol	Interlink	interlink
Internationalization	Internationalization	lcp.opt.internationalization
TwinCAT IO-RAW	IO-RAW	ioraw
DCOM OXID Resolver	IOXIDResolver	oxid
IP Address	IP Address	ipcp.opt.addr
IP Addresses (deprecated)	IP Addresses (deprecated)	ipcp.opt.addrs
IP Compression Protocol	IP Compression Protocol	ipcp.opt.compress
Apple IP-over-IEEE 1394	IP/IEEE1394	ap1394
GSM over IP ip.access CCM sub-protocol	IPA	ipaccess
International Passenger Airline Reservation System	IPARS	ipars
IP Payload Compression	IPComp	ipcomp
IP Device Control (SS7 over IP)	IPDC	ipdc
IPDR	IPDR/SP	ipdr
iPerf2 Packet Data	iPerf2	iperf2
IP Over FC	IPFC	ipfc
Intelligent Platform Management Bus	IPMB	ipmb
Intelligent Platform Management Interface	IPMI	ipmi
Intelligent Platform Management Interface (Session Wrapper)	IPMI Session	ipmi_session
IPMI Trace Data Collection	ipmi-trace	ipmi.trace
Solaris IPNET	IPNET	ipnet
IP over Infiniband	IPoIB	ipoib
IPOS Kernel Packet Protocol	IPOS	ipos
Internet Printing Protocol	IPP	ipp
Internet Printing Protocol Over USB	IPPUSB	ippusb
DCOM IProvideClassInfo	IProvideClassInfo	provideclassinfo
IPSICTL	IPSICTL	ipsictl
Internet Protocol Version 4	IPv4	ip
MIPv6 Option - IPv4 Address Acknowledgement	IPv4 Address Acknowledgement	mip6.options.ipv4aa
MIPv6 Option - IPv4 Care-of Address	IPv4 Care-of Address	mip6.options.ipv4coa
IPv4 Default Router Address	IPv4 Default Router Address	vsncp.opt.ipv4address
MIPv6 Option - IPv4 Default-Router Address	IPv4 Default-Router Address	mip6.options.ipv4dra
MIPv6 Option - IPv4 DHCP Support Mode	IPv4 DHCP Support Mode	mip6.options.ipv4dsm
MIPv6 Option - IPv4 Home Address	IPv4 Home Address	mip6.options.ipv4ha
MIPv6 Option - IPv4 Home Address Reply	IPv4 Home Address Reply	mip6.options.ipv4harep
MIPv6 Option - IPv4 Home Address Request	IPv4 Home Address Request	mip6.options.ipv4hareq
Internet Protocol Version 6	IPv6	ipv6
IPv6 compression	IPv6 compression	ipv6cp.opt.compress
Destination Options for IPv6	IPv6 Destination	ipv6.dstopts
Fragment Header for IPv6	IPv6 Fragment	ipv6.fraghdr
IPv6 Hop-by-Hop Option	IPv6 Hop-by-Hop	ipv6.hopopts
IPv6 HSGW Link Local Address IID	IPv6 HSGW Link Local Address IID	vsncp.opt.ipv6_hsgw_lla_iid
Routing Header for IPv6	IPv6 Routing	ipv6.routing
IP Virtual Services Sync Daemon	IPVS	ipvs
Internetwork Packet eXchange	IPX	ipx
IPX Message	IPX MSG	ipxmsg
IPX Routing Information Protocol	IPX RIP	ipxrip
Service Advertisement Protocol	IPX SAP	ipxsap
IPX WAN	IPX WAN	ipxwan
Internet Relay Chat	IRC	irc
IrCOMM Protocol	IrCOMM	ircomm
IRemoteWinspool SubSystem	IREMOTEWINSPOOL	iremotewinspool
IRemUnknown	IRemUnknown	remunk
IRemUnknown2	IRemUnknown2	remunk2
IrDA Link Access Protocol	IrLAP	irlap
IrDA Link Management Protocol	IrLMP	irlmp
Internet Security Association and Key Management Protocol	ISAKMP	isakmp
iSCSI	iSCSI	iscsi
ISDN	ISDN	isdn
ISDN supplementary services	ISDN_SUP	isdn_sup
iSCSI Extensions for RDMA	iSER	iser
Intelligent Service Interface	ISI	isi
ISO 10589 ISIS InTRA Domain Routeing Information Exchange Protocol	ISIS	isis
ISO 10589 ISIS Complete Sequence Numbers Protocol Data Unit	ISIS CSNP	isis.csnp
ISIS HELLO	ISIS HELLO	isis.hello
ISO 10589 ISIS Link State Protocol Data Unit	ISIS LSP	isis.lsp
ISO 10589 ISIS Partial Sequence Numbers Protocol Data Unit	ISIS PSNP	isis.psnp
Cisco ISL	ISL	isl
ISMACryp Protocol	ISMACRYP	ismacryp
ISMACryp Protocol v1.1	ISMACRYP 1.1	ismacryp_v11
ISMACryp Protocol v2.0	ISMACRYP 2.0	ismacryp_v20
InterSwitch Message Protocol	ISMP	ismp
iSNS	iSNS	isns
ISO10681 Protocol	ISO 10681	iso10681
ISO/IEC 14443	ISO 14443	iso14443
ISO15765 Protocol	ISO 15765	iso15765
ISO/IEC 7816	ISO 7816	iso7816
ISO/IEC 7816-3	ISO 7816-3	iso7816.atr
ISO 8583-1	ISO 8583	iso8583
ISObus	ISOBUS	isobus
ISObus Virtual Terminal	ISObus VT	isobus.vt
ISDN User Part	ISUP	isup
ISystemActivator ISystemActivator Resolver	ISystemActivator	isystemactivator
Internal TDM	ITDM	itdm
Intelligent Transport Systems	ITS	its
iTunes podCast rss elements	itunes	itunes
DCOM ITypeInfo	ITypeInfo	typeinfo
ISDN Q.921-User Adaptation Layer	IUA	iua
IuUP	IuUP	iuup
ITS message - IVIM	IVIM	its.message.ivim
ITS message - IVIMv1	IVIMv1	its.message.ivimv1
iWARP Direct Data Placement and Remote Direct Memory Access Protocol	IWARP_DDP_RDMAP	iwarp_ddp_rdmap
iWARP Marker Protocol data unit Aligned framing	IWARP_MPA	iwarp_mpa
Ixia Trailer	IXIATRAILER	ixiatrailer
ixveriwave	ixveriwave	ixveriwave
SAE J1939	J1939	j1939
Java Debug Wire Protocol	JDWP	jdwp
JPEG File Interchange Format	JFIF (JPEG) image	image-jfif
Juniper Packet Mirror	Jmirror	jmirror
RFC 2435 JPEG	JPEG	jpeg
JavaScript Object Notation	JSON	json
JSON 3GPP	JSON_3GPP	json_3gpp
Juniper	Juniper	juniper
JXTA P2P	JXTA	jxta
JXTA Message	JXTA Message	jxta.message
K12xx	K12xx	k12
Kerberos Administration	KADM5	kadm5
Kafka	Kafka	kafka
Keyboard Controller Style Interface	KCS	kcs
Kontiki Delivery Protocol	KDP	kdp
Kismet Drone/Server Protocol	KDSP	kdsp
QNX6 QNET KIF protocol	KIF	kif
Kingfisher	Kingfisher	kf
Kerberized Internet Negotiation of Key	KINK	kink
Kismet Client/Server Protocol	Kismet	kismet
Kernel Lock Manager	KLM	klm
kNet Protocol	KNET	knet
KNFSD_LE	knfsd_le	nfs.knfsd_le
KNFSD_NEW	knfsd_new	nfs.knfsd_new
KNX/IP	KNX/IP	kip
MS Kpasswd	Kpasswd	kpasswd
Kerberos v4	KRB4	krb4
Kerberos	KRB5	kerberos
DCE/RPC Kerberos V	KRB5RPC	krb5rpc
Kyoto Tycoon Protocol	Kyoto Tycoon	kt
Landis & Gyr Telegyr 8979	L&G 8979	lg8979
Layer 2 Tunneling Protocol	L2TP	l2tp
LAN-Identification (obsoleted)	LAN-Identification (obsoleted)	bcp_ncp.opt.lan_id
LANforge Traffic Generator	LANforge	lanforge
Microsoft Windows Lanman Remote API Protocol	LANMAN	lanman
Link Access Procedure Balanced (LAPB)	LAPB	lapb
Link Access Procedure Balanced Ethernet (LAPBETHER)	LAPBETHER	lapbether
Link Access Procedure, Channel D (LAPD)	LAPD	lapd
Link Access Procedure, Channel Dm (LAPDm)	LAPDm	lapdm
Laplink	Laplink	laplink
Link Access Procedure, Satellite channel (LAPSat)	LAPSat	lapsat
Local Area Transport	LAT	lat
Layer 1 Event Messages	Layer 1 Events	data-l1-events
LBMC Protocol	LBMC	lbmc
LBMPDM Protocol	LBMPDM	lbmpdm
LBMPDM over TCP Protocol	LBMPDM-TCP	lbmpdm_tcp
LBM Topic Resolution Protocol	LBMR	lbmr
LBM Stateful Resolution Service Protocol	LBMSRS	lbmsrs
LBT Reliable Multicast Protocol	LBT-RM	lbtrm
LBT Reliable Unicast Protocol	LBT-RU	lbtru
LBT TCP Protocol	LBT-TCP	lbttcp
LCS Application Protocol	LCSAP	lcsap
H.283 Logical Channel Transport	LCT	lct
LDAC Codec	LDAC	ldac
Lightweight Directory Access Protocol	LDAP	ldap
Label Distribution Protocol	LDP	ldp
Local Download Sharing Service	LDSS	ldss
LGE Monitor	LGE_Monitor	lge_monitor
LIN Protocol	LIN	lin
ACF LIN	LIN over AVTP	acf-lin
Line-based text data	Line-based text data	data-text-lines
Line-Identification	Line-Identification	bcp_ncp.opt.line_id
LACP	Link Aggregation Control Protocol	lacp
Marker	Link Aggregation Marker Protocol	marker
Link Discriminator	Link Discriminator	bap.opt.link_disc
Link Discriminator for BACP	Link Discriminator for BACP	lcp.opt.link_discrim_bytes
Link Quality Monitoring	Link Quality Monitoring	lcp.opt.linkqualmon
Link Type	Link Type	bap.opt.link_type
MIPv6 Option - Link-local Address	Link-local Address	mip6.options.lla
Link 16	LINK16	link16
ENEA LINX	LINX	linx
ENEA LINX over TCP	LINX/TCP	linxtcp
Locator/ID Separation Protocol	LISP Control	lisp
Locator/ID Separation Protocol (Data)	LISP Data	lisp-data
Locator/ID Separation Protocol (Reliable Transport)	LISP Reliable Transport	lisp-tcp
Event Notification for Resource Lists (RFC 4662)	list	list
Lithionics Battery Management System	Lithionics BMS	lithionics_bms
LocalTalk Link Access Protocol	LLAP	llap
DCE/RPC NCS 1.5.1 Local Location Broker	llb	llb
Logical-Link Control	LLC	llc
Link Layer Discovery Protocol	LLDP	lldp
Link-local Multicast Name Resolution	LLMNR	llmnr
Low Level Reader Protocol	LLRP	llrp
Veritas Low Latency Transport (LLT)	LLT	llt
Link Layer Topology Discovery	LLTD	lltd
Local Management Interface	LMI	lmi
Link Management Protocol (LMP)	LMP	lmp
Lustre Network	LNet	lnet
Local Number Portability Database Query	LNPDQP	lnpdqp
MIPv6 Option - Load Information	Load Information	mip6.options.load_inf
Log Message	Log	log
3GPP log packet	LOG3GPP	log3gpp
Android Logcat	Logcat	logcat
Android Logcat Text	Logcat Text	logcat_text
Logotype Certificate Extensions	LogotypeCertExtn	logotypecertextn
Local Operating Network	LON	lon
Configuration Test Protocol (loopback)	LOOP	loop
IP Option - Loose Source Route	Loose Source Route	ip.options.route
LoRaTap header	LoRaTap	loratap
LoRaWAN Protocol	LoRaWAN	lorawan
Line Printer Daemon Protocol	LPD	lpd
LTE Positioning Protocol (LPP)	LPP	lpp
LTE Positioning Protocol A (LPPa)	LPPa	lppa
LTE Positioning Protocol Extensions (LLPe)	LPPe	lppe
QNX6 QNET LR protocol	LR	lr
Local Security Authority	LSARPC	lsarpc
Pegasus Lightweight Stream Control	LSC	lsc
Local Service Discovery	LSD	lsd
LTE Radio Resource Control (RRC) protocol	LTE RRC	lte_rrc
Licklider Transmission Protocol	LTP	ltp
Lucent/Ascend debug output	Lucent/Ascend	ascend
Lustre	lustre	lustre
LWAPP Encapsulated Packet	LWAPP	lwapp
LWAPP Control Message	LWAPP-CNTL	lwapp-cntl
LWAPP Layer 3 Packet	LWAPP-L3	lwapp-l3
QNX6 QNET LWL4 protocol	LWL4	lwl4
Lightweight M2M TLV	LwM2M-TLV	lwm2mtlv
Lightweight Mesh (v1.1.1)	LwMesh	lwm
Light Weight DNS RESolver (BIND9)	LWRES	lwres
LZS-DCP	LZS-DCP	ccp.opt.lzsdcp
M2 Application Protocol	M2AP	m2ap
WiMax Mac to Mac Packet	M2M  (m2m)	m2m
MTP2 Peer Adaptation Layer	M2PA	m2pa
MTP 2 Transparent Proxy	M2TP	m2tp
MTP 2 User Adaptation Layer	M2UA	m2ua
M3 Application Protocol	M3AP	m3ap
MTP 3 User Adaptation Layer	M3UA	m3ua
Message Analyzer WFP Capture AUTH v4	MA WFP Capture AUTH v4	message_analyzer.wfp_capture.auth.v4
Message Analyzer WFP Capture AUTH v6	MA WFP Capture AUTH v6	message_analyzer.wfp_capture.auth.v6
Message Analyzer WFP Capture v4	MA WFP Capture v4	message_analyzer.wfp_capture.v4
Message Analyzer WFP Capture v6	MA WFP Capture v6	message_analyzer.wfp_capture.v6
Message Analyzer WFP Capture2 v4	MA WFP Capture2 v4	message_analyzer.wfp_capture2.v4
Message Analyzer WFP Capture2 v6	MA WFP Capture2 v6	message_analyzer.wfp_capture2.v6
IEEE 1722 MAAP Protocol	MAAP	maap
MAC	MAC	mac
MAC-Address	MAC-Address	bcp_ncp.opt.mac_addr
MAC-LTE	MAC-LTE	mac-lte
mac-lte-framed	MAC-LTE-FRAMED	mac-lte-framed
MAC-NR	MAC-NR	mac-nr
MAC-Support	MAC-Support	bcp_ncp.opt.mac_sup
MikroTik MAC-Telnet Protocol	MAC-Telnet	mactelnet
MAC Control	MACC	macc
802.1AE Security tag	MACsec	macsec
MIPv6 Option - MAG IPv6 Address	MAG IPv6 Address	mip6.options.mag_ipv6
Magic Bullet	MAGIC	magic
Magic Number	Magic Number	lcp.opt.magic_number_bytes
Malformed Packet	Malformed packet	_ws.malformed
Management Inline	Management Inline	bcp_ncp.opt.management_inline
Blubster/Piolet MANOLITO Protocol	Manolito	manolito
ITS message - MAPEM	MAPEM	its.message.mapem
ITS message - MAPEMv1	MAPEMv1	its.message.mapemv1
Exchange 5.5 EMSMDB	MAPI	mapi
Meta Analysis Tracing Engine	MATE	mate
Media Agnostic USB	MAUSB	mausb
Maximum Receive Unit	Maximum Receive Unit	lcp.opt.mtu_bytes
TCP Option - Maximum segment size	Maximum segment size	tcp.options.mss
Mobile Broadband Interface Model	MBIM	mbim
.NET Message Framing Protocol	MC-NMF	mc-nmf
Miscabling Protocol	MCP	mcp
Minecraft Pocket Edition	MCPE	mcpe
Multicast Domain Name System	mDNS	mdns
Meraki Discovery Protocol	MDP	mdp
MDS Header	MDS Header	mdshdr
Spotlight metadata search service	MDSSVC	mdssvc
Media Type	Media	media
MPLS-MAC	Media Access Control (MAC) Address Withdrawal over Static Pseudowire	mpls_mac
MEGACO	MEGACO	megaco
Mellanox EoIB Encapsulation Header	Mellanox EoIB	infiniband.eoib
Memcache Protocol	MEMCACHE	memcache
MIPv6 Option - MESG-ID-OPTION-TYPE	MESG-ID-OPTION-TYPE	mip6.options.mseg_id
Mesh Header	Mesh	mesh
Media Type: message/http	message/http	message-http
Microsoft Messenger Service	Messenger	messenger
Metadata	META	meta
Metamako ethernet trailer	Metamako	metamako
Media Gateway Control Protocol	MGCP	mgcp
DCE/RPC Remote Management	MGMT	mgmt
WiMax MAC Management Message	MGMT MSG	wmx.mgmt
Microsoft PPE/PPC	Microsoft PPE/PPC	ccp.opt.mppe
NXP MiFare	MiFare	mifare
Media-Independent Handover	MIH	mih
Multimedia Internet KEYing	MIKEY	mikey
MIME Multipart Media Encapsulation	MIME multipart	mime_multipart
MIME file	MIME_FILE	mime_dlt
Media Independent Network Transport	MINT	mint
Media Independent Network Transport Data	MINT (Data)	mint_data
Unreliable Multicast Inter-ORB Protocol	MIOP	miop
Mobile IPv6	MIPv6	mipv6
MISC (pidl)	MISC	misc
Mesh Link Establishment	MLE	mle
MMS	MMS	mms
MMS Message Encapsulation	MMSE	mmse
Mikrotik Neighbor Discovery Protocol	MNDP	mndp
Mobile IP	Mobile IP	mip
MIPv6 Option - Mobile Network Prefix	Mobile Network Prefix	mip6.options.mnp
MIPv6 Option - Mobile Node Group Identifier	Mobile Node Group Identifier	mip6.options.mng
MIPv6 Option - Mobile Node Identifier	Mobile Node Identifier	mip6.options.mnid
MIPv6 Option - Mobile Node Link-layer Identifier	Mobile Node Link-layer Identifier	mip6.options.mnlli
MIPv6 Option - Mobile Node Link-local Address Interface Identifier	Mobile Node Link-local Address Interface Identifier	mip6.options.lmaa
Mobile Node's Home IP Address	Mobile Node's Home IP Address	ipcp.opt.mobileipv4
MIPv6 Option - Mobility Header IPv6 Address/Prefix	Mobility Header IPv6 Address/Prefix	mip6.options.mhipv6ap
MIPv6 Option - Mobility Header Link-Layer Address	Mobility Header Link-Layer Address	mip6.options.mhlla
Modbus	Modbus	modbus
Modbus RTU	Modbus RTU	mbrtu
Modbus/TCP	Modbus/TCP	mbtcp
Modbus/UDP	Modbus/UDP	mbudp
Mojito DHT	Mojito	mojito
MoldUDP	MoldUDP	moldudp
MoldUDP64	MoldUDP64	moldudp64
Mongo Wire Protocol	MONGO	mongo
Mount Service	MOUNT	mount
ISO/IEC 13818-1	MP2T	mp2t
MP4 / ISOBMFF file format	mp4	mp4
MP4V-ES	MP4V-ES	mp4v-es
Moving Picture Experts Group	MPEG	mpeg
Moving Picture Experts Group Audio	MPEG Audio	mpeg-audio
MPEG2 Conditional Access Table	MPEG CA	mpeg_ca
MPEG2 Descriptors	MPEG Descriptor	mpeg_descr
MPEG DSM-CC	MPEG DSM-CC	mpeg_dsmcc
MPEG2 Program Association Table	MPEG PAT	mpeg_pat
Packetized Elementary Stream	MPEG PES	mpeg-pes
MPEG2 Program Map Table	MPEG PMT	mpeg_pmt
MPEG2 Section	MPEG SECT	mpeg_sect
RFC 2250 MPEG1	MPEG1	mpeg1
MultiProtocol Label Switching Header	MPLS	mpls
MPLS Delay Measurement (DM)	MPLS Delay Measurement (DM)	mplspmdm
MPLS Direct Loss and Delay Measurement (DLM+DM)	MPLS Direct Loss and Delay Measurement (DLM+DM)	mplspmdlmdm
MPLS Direct Loss Measurement (DLM)	MPLS Direct Loss Measurement (DLM)	mplspmdlm
Multiprotocol Label Switching Echo	MPLS Echo	mpls-echo
MPLS Inferred Loss and Delay Measurement (ILM+DM)	MPLS Inferred Loss and Delay Measurement (ILM+DM)	mplspmilmdm
MPLS Inferred Loss Measurement (ILM)	MPLS Inferred Loss Measurement (ILM)	mplspmilm
MPLS ITU-T Y.1711 OAM	MPLS ITU-T Y.1711 OAM	mpls_y1711
MPLS PW ATM One-to-One or AAL5 PDU encapsulation	MPLS PW ATM 1:1 / AAL5 PDU	mplspwatm11_or_aal5pdu
MPLS PW ATM AAL5 CPCS-SDU mode encapsulation	MPLS PW ATM AAL5 SDU	mplspwatmaal5sdu
MPLS PW ATM Cell Header	MPLS PW ATM Cell Header	mplspwatmcellheader
MPLS PW ATM Control Word	MPLS PW ATM Control Word	mplspwatmcontrolword
MPLS PW ATM N-to-One encapsulation, with CW	MPLS PW ATM N:1 CW	mplspwatmn1cw
MPLS PW ATM N-to-One encapsulation, no CW	MPLS PW ATM N:1 no CW	mplspwatmn1nocw
MPLS-TP Fault-Management	MPLS[-TP] Fault-Management Fault-Management (FM) Protocol	mplstp_fm
MPLS-TP Lock-Instruct	MPLS[-TP] Lock-Instruct Lock-Instruct (LI) Protocol	mplstp_lock
PSC	MPLS[-TP] Protection State Coordination (PSC) Protocol	mpls_psc
Multipath Transmission Control Protocol	MPTCP	mptcp
WebSphere MQ	MQ	mq
WebSphere MQ Programmable Command Formats	MQ PCF	mqpcf
MQ Telemetry Transport Protocol	MQTT	mqtt
MQ Telemetry Transport Protocol for Sensor Networks	MQTT-SN	mqttsn
Media Resource Control Protocol Version 2 (MRCPv2)	MRCPv2	mrcpv2
Multicast Router DISCovery protocol	MRDISC	mrdisc
Multiple Mac Registration Protocol	MRP-MMRP	mrp-mmrp
Multiple Stream Reservation Protocol	MRP-MSRP	mrp-msrp
Multiple VLAN Registration Protocol	MRP-MVRP	mrp-mvrp
MS Network Load Balancing	MS NLB	msnlb
MS Proxy Protocol	MS Proxy	msproxy
.NET NegotiateStream Protocol	MS-NNS	ms-nns
Windows Search Protocol	MS-WSP	mswsp
Media Server Control Markup Language - draft 07	mscml	mscml
Multicast Source Discovery Protocol	MSDP	msdp
Message Pack	MsgPack	msgpack
Microsoft Media Server	MSMMS	msmms
MSNIP: Multicast Source Notification of Interest Protocol	MSNIP	msnip
MSN Messenger Service	MSNMS	msnms
Message Session Relay Protocol	MSRP	msrp
NexusWare C7 MTP	MTP over NW UDP	nw_mtp
Message Transfer Part Level 2	MTP2	mtp2
Message Transfer Part Level 3	MTP3	mtp3
Message Transfer Part Level 3 Management	MTP3MG	mtp3mg
IP Option - MTU Probe	MTU Probe	ip.options.mtu_probe
IP Option - MTU Reply	MTU Reply	ip.options.mtu_reply
MUDURL	MUDURL	mudurl
Multi Link Plus Procedure	Multi Link Plus Procedure	lcp.opt.multilink_pp
Multilink Endpoint Discriminator	Multilink Endpoint Discriminator	lcp.opt.multilink_ep_disc
Multilink header format	Multilink header format	lcp.opt.multilink_hdr_fmt
Multilink MRRU	Multilink MRRU	lcp.opt.multilink_mrru
Multilink Short Sequence Number Header	Multilink Short Sequence Number Header	lcp.opt.multilink_ssnh
MUX27010 Protocol	MUX27010	mux27010
MVRCA (Magnalink)	MVRCA (Magnalink)	ccp.opt.mvrca
MySQL Protocol	MySQL	mysql
NAN protocol	NAN	nan
Nano Cryptocurrency Protocol	Nano	nano
Non-Access-Stratum 5GS (NAS)PDU	NAS-5GS	nas-5gs
Non-Access-Stratum (NAS)PDU	NAS-EPS	nas-eps
Nasdaq TotalView-ITCH	NASDAQ-ITCH	nasdaq_itch
Nasdaq-SoupTCP version 2.0	NASDAQ-SOUP	nasdaq_soup
MIPv6 Option - NAT Detection	NAT Detection	mip6.options.natd
NAT Port Mapping Protocol	NAT-PMP	nat-pmp
3GPP Nb Interface RTP Multiplex	NB_RTPMUX	nb_rtpmux
UTRAN Iub interface NBAP signalling	NBAP	nbap
Network Block Device	NBD	nbd
NetBIOS Datagram Service	NBDS	nbdgm
Network-Based IP Flow Mobility	NBIFOM	nbifom
NetBIOS over IPX	NBIPX	nbipx
NetBIOS Name Service	NBNS	nbns
Name Binding Protocol	NBP	nbp
NetBIOS Session Service	NBSS	nbss
NetWare Core Protocol	NCP	ncp
Novell Cluster Services	NCS	ncs
NCSI	NCSI	ncsi
Network Data Management Protocol	NDMP	ndmp
Nortel Discovery Protocol	NDP	ndp
Novell Distributed Print System	NDPS	ndps
SPNEGO Extended Negotiation Security Mechanism	NEGOEX	negoex
Negotiating header compression (RFC3545)	Negotiating header compression (RFC3545)	ipcp.opt.iphc.neghdrcomp
Amateur Radio NET/ROM	NET/ROM	netrom
Linux net_dm (network drop monitor) protocol	net_dm	net_dm
netANALYZER	netANALYZER	netanalyzer
NetBIOS	NetBIOS	netbios
Settings for Microsoft Distributed File System	NETDFS	netdfs
Netdump Protocol	Netdump	netdump
Linux netlink netfilter protocol	netfilter	netlink-netfilter
Linux netlink protocol	NETLINK	netlink
NetMon 802.11 capture header	NetMon 802.11	netmon_802_11
Network Monitor Event	NetMon Event	netmon_event
Network Monitor Filter	NetMon Filter	netmon_filter
Network Monitor Header	NetMon Header	netmon_header
Network Monitor Network Info	NetMon Network Info	netmon_network_info
Network Monitor Process	NetMon Process	netmon_process
Network Monitor System Config	NetMon System Config	netmon_system_config
Network Monitor System Trace	NetMon System Trace	netmon_system_trace
NetPerfMeter Protocol	NetPerfMeter	netperfmeter
Netrix Communication Protocol	Netrix	netrix
NetScaler HA Protocol	NetScaler HA	nstrace.ha
NetScaler Metric Exchange Protocol	NetScaler MEP	nstrace.mep
NetScaler RPC Protocol	NetScaler RPC	nstrace.rpc
Monotone Netsync	Netsync	netsync
HP-UX Network Tracing and Logging	nettl	nettl
Microsoft Exchange New Mail Notification	NEWMAIL	newmail
Nfapi	NFAPI	nfapi
Linux Netfilter NFLOG	NFLOG	nflog
Network File System	NFS	nfs
Network File System CB	NFS CB	nfs.cb
NFSACL	NFSACL	nfsacl
NFSAUTH	NFSAUTH	nfsauth
NFSD_LE	nfsd_le	nfs.nfsd_le
NG Application Protocol	NGAP	ngap
Netgear Ensemble Protocol	NGE	nge
NBMA Next Hop Resolution Protocol	NHRP	nhrp
NIS+	NIS+	nisplus
NIS+ Callback	NIS+ CB	nispluscb
NIST_CSOR	NIST_CSOR	nist_csor
3com Network Jack	NJACK	njack
Linux 802.11 Netlink	nl80211	nl80211
Network Lock Manager Protocol	NLM	nlm
NetWare Link Services Protocol	NLSP	nlsp
Novell Modular Authentication Service	NMAS	nmas
Name Management Protocol over IPX	NMPI	nmpi
Network News Transfer Protocol	NNTP	nntp
No callback	No callback	cbcp.opt.no_callback
IP Option - No-Operation (NOP)	No Operation (NOP)	ip.options.nop
No Phone Number Needed	No Phone Number Needed	bap.opt.no_phone
TCP Option - No-Operation (NOP)	No-Operation (NOP)	tcp.options.nop
NOE Protocol	NOE	noe
F5 Ethernet trailer provider - Noise	Noise	f5ethtrailer.provider.noise
Nominal Data Encapsulation (Deprecated)	Nominal Data Encapsulation (Deprecated)	lcp.opt.nomdataencap
MIPv6 Option - Nonce Indices	Nonce Indices	mip6.options.ni
nRF Sniffer for Bluetooth LE	NORDIC_BLE	nordic_ble
Negative-acknowledgment Oriented Reliable Multicast	NORM	norm
Novell PKIS ASN.1 type	novell_pkis	novell_pkis
QNX6 QNET Network Resolver protocol	NR	nr
NR Radio Resource Control (RRC) protocol	NR RRC	nr-rrc
NR Positioning Protocol A (NRPPa)	NRPPa	nrppa
NRUP	NRUP	nrup
NetScaler Trace	NS Trace	ns
NetScape Certificate Extensions	NS_CERT_EXTS	ns_cert_exts
Network Service Header	NSH	nsh
Exchange 5.5 Name Service Provider	NSPI	nspi
Juniper Netscreen Redundant Protocol	NSRP	nsrp
NTLM Secure Service Provider	NTLMSSP	ntlmssp
Network Time Protocol	NTP	ntp
Non-Time-Synchronous Control Format	NTSCF	ntscf
Null/Loopback	Null	null
Number-String Decoding Error	Number-string decoding error	_ws.number_string.decoding_error
Numbered Mode	Numbered Mode	lcp.opt.numbered_mode
NVM Express	nvme	nvme
NVM Express Fabrics RDMA	NVMe Fabrics RDMA	nvme-rdma
NVM Express Fabrics TCP	NVMe/TCP	nvme-tcp
NetWare Serialization Protocol	NW_SERIAL	nw_serial
Neighborhood Watch Protocol	NWP	nwp
NXP 802.15.4 Sniffer Protocol	NXP 802154 Sniffer	nxp_802154_sniffer
O-RAN Fronthaul CUS	O-RAN FH CUS	oran_fh_cus
ATM OAM AAL	OAM AAL	oamaal
OBD-II PID	OBD-II	obd-ii
OBEX Protocol	OBEX	obex
OCFS2 Networking	OCFS2	ocfs2
Online Certificate Status Protocol	OCSP	ocsp
Octet Encoding Rules (ASN.1)	OER	oer
OICQ - IM software, popular in China	OICQ	oicq
Open IPTV Forum CSPG-CI+	OIPF CI+	oipf.ciplus
Optimized Link State Routing Protocol	OLSR	olsr
ISC Object Management API	OMAPI	omapi
OMRON FINS Protocol	OMRON FINS	omron
ONTAP_GX_V3	ontap_gx_v3	nfs.ontap_gx_v3
ONTAP_V3	ontap_v3	nfs.ontap_v3
ONTAP_V4	ontap_v4	nfs.ontap_v4
Intel Omni-Path	OPA	opa
Intel Omni-Path FE Header - Omni-Path Fabric Executive Header	OPA FE	opa.fe
Intel Omni-Path MAD	OPA MAD	opa.mad
Intel Omni-Path SnC - Omni-Path Snoop and Capture MetaData Header	OPA SnC	opa.snc
OpcUa Binary Protocol	OpcUa	opcua
OpenFlow	OpenFlow	openflow
OpenFlow 1.0	openflow_v1	openflow_v1
OpenFlow 1.3	openflow_v4	openflow_v4
OpenFlow 1.4	openflow_v5	openflow_v5
OpenFlow 1.5	openflow_v6	openflow_v6
openSAFETY	openSAFETY	opensafety
openSAFETY over UDP	openSAFETY ov. UDP	opensafety_udp
OpenThread	OpenThread	openthread
OpenVPN Protocol	OpenVPN	openvpn
OpenWire	OpenWire	openwire
Open Policy Service Interface	OPSI	opsi
OptoMMP	OptoMMP	optommp
Opus Interactive Audio Codec	OPUS	opus
OSSP	Organization Specific Slow Protocol	ossp
Open Sound Control Encoding	OSC	osc
Object Security for Constrained RESTful Environments	OSCORE	oscore
OSI	OSI	osi
OsmoTRX Control / Clock Protocol	OsmoTRXC	osmo_trxc
OsmoTRX Data Protocol	OsmoTRXD	osmo_trxd
Open Shortest Path First	OSPF	ospf
OUCH	OUCH	ouch
OUI	OUI	ccp.opt_oui
One-way Active Measurement Protocol	OWAMP-Test	owamp.test
X.411 Message Transfer Service	P1	p1
X.420 Information Object	P22	p22
X.411 Message Access Service	P3	p3
X.413 Message Store Service	P7	p7
STANAG 4406 Message	P772	p772
P_Mul (ACP142)	P_MUL	p_mul
PacketBB Protocol	PacketBB	packetbb
PacketCable AVPs	PACKETCABLE	packetcable_avps
MIPv6 Option - Pad1	Pad1	mip6.options.pad1
MIPv6 Option - PadN	PadN	mip6.options.padn
Port Aggregation Protocol	PAGP	pagp
Palo Alto Heartbeat Backup	Palo Alto Heartbeat Backup	hbbak
Paltalk Messenger Protocol	Paltalk	paltalk
Protocol for carrying Authentication for Network Access	PANA	pana
Aruba PAPI	PAPI	papi
Parlay Dissector Using GIOP API	PARLAY	giop-parlay
Pathport Protocol	Pathport	pathport
UTRAN Iupc interface Positioning Calculation Application Part (PCAP)	PCAP	pcap
pcap/pcapng packet data	pcap_pktdata	pcap_pktdata
Pcapng block	PCAPNG	pcapng
Path Computation Element communication Protocol	PCEP	pcep
Packet Cable Lawful Intercept	PCLI	pcli
Packet Cable Lawful Intercept (timestamp)	PCLI12 (timestamp)	pcli12
Packet Cable Lawful Intercept (timestamp, case ID)	PCLI20 (timestamp, case ID)	pcli20
Packet Cable Lawful Intercept (8 byte CCCID)	PCLI8 (8 byte CCCID)	pcli8
PC NFS	PCNFSD	pcnfsd
PCOM ASCII	PCOM ASCII	pcomascii
PCOM BINARY	PCOM BINARY	pcombinary
PCOM/TCP	PCOM/TCP	pcomtcp
Performance Co-Pilot	PCP	pcp
Primary_Data	pd	nfs.primary_data
PDC Protocol	PDC	pdc
PDCP-LTE	PDCP-LTE	pdcp-lte
PDCP-NR	PDCP-NR	pdcp-nr
PDN Address	PDN Address	vsncp.opt.pdnaddress
PDN Identifier	PDN Identifier	vsncp.opt.pdnid
PDN Type	PDN Type	vsncp.opt.pdntype
PDU Transport Protocol	PDU Transport	pdu_transport
AiroPeek/OmniPeek encapsulated IEEE 802.11	PEEKREMOTE	peekremote
Packed Encoding Rules (ASN.1 X.691)	PER	per
MIPv6 Option - Permanent Home Keygen Token	Permanent Home Keygen Token	mip6.options.phkt
Packet Forwarding Control Protocol	PFCP	pfcp
OpenBSD Packet Filter log file	PFLOG	pflog
OpenBSD Packet Filter log file, pre 3.4	PFLOG-OLD	pflog-old
Pragmatic General Multicast	PGM	pgm
PostgreSQL	PGSQL	pgsql
Phone Delta	Phone Delta	bap.opt.phone_delta
Protocol Independent Multicast	PIM	pim
Ping Pong Protocol	PingPongProtocol	pingpongprotocol
PKCS#1	PKCS-1	pkcs-1
PKCS10 Certification Request	PKCS10	pkcs10
PKCS#12: Personal Information Exchange	PKCS12	pkcs12
PKINIT	PKInit	pkinit
PKIX CERT File Format	PKIX Certificate	pkix-cert
PKIX1Explicit	PKIX1EXPLICIT	pkix1explicit
PKIX1Implitit	PKIX1IMPLICIT	pkix1implicit
PKIX Attribute Certificate	PKIXAC	pkixac
PKIXProxy (RFC3820)	PKIXPROXY	pkixproxy
PKIX Qualified	PKIXQUALIFIED	pkixqualified
PKIX Time Stamp Protocol	PKIXTSP	pkixtsp
PacketCable Call Content Connection	PKT CCC	pkt_ccc
Packet comments	Pkt_Comment	pkt_comment
PKTAP packet header	PKTAP	pktap
PacketCable	PKTC	pktc
PacketCable MTA FQDN	PKTC MTA FQDN	pktc.mtafqdn
Linux Kernel Packet Generator	PKTGEN	pktgen
PacketLogger	PKTLOG	packetlogger
Performance Co-Pilot Proxy	PMPROXY	pmproxy
PROFINET DCP	PN-DCP	pn_dcp
PROFINET MRP	PN-MRP	pn_mrp
PROFINET MRRT	PN-MRRT	pn_mrrt
PROFINET PTCP	PN-PTCP	pn_ptcp
PROFINET Real-Time Protocol	PN-RT	pn_rt
NXP PN532	PN532	pn532
NXP PN532 HCI	PN532_HCI	pn532_hci
Portable Network Graphics	PNG	png
PROFINET IO	PNIO	pn_io
PROFINET IO (Apdu Status)	PNIO (Apdu Status)	pn_io_apdu_status
PROFINET IO (Controller)	PNIO (Controller Interface)	pn_io_controller
PROFINET IO (Device)	PNIO (Device Interface)	pn_io_device
PROFINET IO (Implicit Ar)	PNIO (Implicit Ar)	pn_io_implicitar
PROFINET IO (Parameter Server)	PNIO (Parameter Server Interface)	pn_io_parameterserver
PROFINET IO (Supervisor)	PNIO (Supervisor Interface)	pn_io_supervisor
Microsoft Plug and Play service	PNP	pnp
Peer Name Resolution Protocol	PNRP	pnrp
poc-settings XML doc (RFC 4354)	poc-settings	poc-settings
Post Office Protocol	POP	pop
Port Control Protocol	Port Control	portcontrol
Portmap	Portmap	portmap
Proprietary PCAP	PPCAP	ppcap
PPI Packet Header	PPI	ppi
PPI antenna decoder	PPI antenna Decoder	ppi_antenna
PPI Geotagging GPS tag decoder	PPI GPS Decoder	ppi_gps
PPI sensor decoder	PPI sensor Decoder	ppi_sensor
PPI vector decoder	PPI vector Decoder	ppi_vector
Point-to-Point Protocol	PPP	ppp
PPP Bandwidth Allocation Control Protocol	PPP BACP	bacp
PPP Bandwidth Allocation Protocol	PPP BAP	bap
PPP Bridging Control Protocol Bridged PDU	PPP BCP BPDU	bcp_bpdu
PPP Bridging Control Protocol Network Control Protocol	PPP BCP NCP	bcp_ncp
PPP Callback Control Protocol	PPP CBCP	cbcp
PPP Compression Control Protocol	PPP CCP	ccp
PPP CDP Control Protocol	PPP CDPCP	cdpcp
PPP Challenge Handshake Authentication Protocol	PPP CHAP	chap
PPP Compressed Datagram	PPP Comp	comp_data
PPP for Data Compression in Data Circuit-Terminating Equipment (DCE)	PPP for Data Compression in Data Circuit-Terminating Equipment (DCE)	ccp.opt.dce
PPP IP Control Protocol	PPP IPCP	ipcp
PPP IPv6 Control Protocol	PPP IPV6CP	ipv6cp
PPP Link Control Protocol	PPP LCP	lcp
PPP Multilink Protocol	PPP MP	mp
PPP MPLS Control Protocol	PPP MPLSCP	mplscp
PPP OSI Network Layer Control Protocol	PPP OSINLCP	osinlcp
PPP Password Authentication Protocol	PPP PAP	pap
PPP Multiplexing	PPP PPPMux	pppmux
PPPMux Control Protocol	PPP PPPMuxCP	pppmuxcp
Vendor Specific Network Protocol	PPP VSNP	vsnp
PPP In HDLC-Like Framing	PPP-HDLC	ppp_hdlc
PPP-over-Ethernet	PPPoE	pppoe
PPP-over-Ethernet Discovery	PPPoED	pppoed
PPP-over-Ethernet Session	PPPoES	pppoes
Point-to-Point Tunnelling Protocol	PPTP	pptp
Printer Access Protocol	PrAP	prap
Predictor type 1	Predictor type 1	ccp.opt.predict1
Predictor type 2	Predictor type 2	ccp.opt.predict2
Prefix Elision	Prefix Elision	lcp.opt.prefix_elision
ISO 8823 OSI Presentation Protocol	PRES	pres
presence XML doc (RFC 3863)	presence	presence
Primary DNS Server IP Address	Primary DNS Server IP Address	ipcp.opt.pri_dns
Primary NBNS Server IP Address	Primary NBNS Server IP Address	ipcp.opt.pri_nbns
Prism capture header	Prism	prism
Profiles (RFC3241)	Profiles (RFC3241)	ipcp.opt.rohc.profile_bytes
Protocol Buffers	ProtoBuf	protobuf
Protocol Configuration Options	Protocol Configuration Options	vsncp.opt.pco
Protocol Field Compression	Protocol Field Compression	lcp.opt.field_compress
PROXY Protocol	PROXY	proxy
Parallel Redundancy Protocol (IEC62439 Part 3)	PRP	prp
Linux psample protocol	psample	psample
Precision Time Protocol (IEEE1588)	PTP	ptp
Picture Transfer Protocol Over IP	PTP/IP	ptpip
Puddle Jumper	Puddle Jumper	ccp.opt.puddle
PULSE protocol for Linux Virtual Server redundancy	PULSE	pulse
Parallel Virtual File System	PVFS	pvfs
PW Associated Channel Header	PW Associated Channel	pwach
Management Communication Channel (MCC)	PW Associated Management Communication Channel	mcc
Pseudowire Padding	PW Padding	pw.padding
Pseudo-Wire OAM	PW-OAM Pseudo-Wire OAM Protocol	pw_oam
Q.2931	Q.2931	q2931
ITU-T Q.708 ISPC Analysis	Q.708	q708
Q.931	Q.931	q931
Q.933	Q.933	q933
Q.932	Q932	q932
Q.932 Operations Service Element	Q932.ROS	q932.ros
Qualified Logical Link Control	QLLC	qllc
QNX6 QNET QOS protocol	QOS	qos
QSIG	QSIG	qsig
Quake Network Protocol	QUAKE	quake
Quake II Network Protocol	QUAKE2	quake2
Quake III Arena Network Protocol	QUAKE3	quake3
QuakeWorld Network Protocol	QUAKEWORLD	quakeworld
Quality Protocol	Quality Protocol	lcp.opt.quality_protocol_bytes
QUIC IETF	QUIC	quic
TCP Option - Quick-Start	Quick-Start	tcp.options.qs
IP Option - Quick-Start	Quick-Start	ip.options.qs
R-GOOSE	R-GOOSE	r-goose
Retix Spanning Tree Protocol	R-STP	r-stp
802.1CB Redundancy Tag	R-Tag	ieee8021cb
R09.x	R09	r09
Assa Abloy R3	R3	r3
RTP Payload for Redundant Audio Data (RFC 2198)	RAD (RFC2198)	rtp_rfc2198
RADIUS Protocol	RADIUS	radius
RakNet game networking protocol	RakNet	raknet
Radio Access Network Application Part	RANAP	ranap
Raw packet data	Raw	raw
OBEX Raw Application Parameters	Raw Application Parameters	obex.parameter.raw
Decompressed SigComp message as raw text	Raw_SigComp	raw_sigcomp
Session Initiation Protocol (SIP as raw text)	Raw_SIP	raw_sip
Ruby Marshal Object	Rbm	rbm
DCE/RPC Directory Acl Interface	rdaclif	rdaclif
H.282 Remote Device Control	RDC	rdc
Remote Device Management	RDM	rdm
RDMnet	RDMnet	rdmnet
Remote Desktop Protocol	RDP	rdp
Remote Desktop Protocol Multi-transport	RDPMT	rdpmt
UDP Remote Desktop Protocol	RDPUDP	rdpudp
Real Data Transport	RDT	rdt
Reason	Reason	bap.opt.reason
IP Option - Record Route	Record Route	ip.options.record_route
Redback	Redback	redback
Redback Lawful Intercept	RedbackLI	redbackli
MIPv6 Option - Redirect	Redirect	mip6.options.redir
MIPv6 Option - Redirect-Capability	Redirect-Capability	mip6.options.recap
Reginfo XML doc (RFC 3680)	reginfo	reginfo
REsource LOcation And Discovery	RELOAD	reload
REsource LOcation And Discovery Framing	RELOAD FRAMING	reload-framing
DCOM IRemoteActivation	REMACT	remact
DCE DFS Replication Server	REP_PROC	rep_proc
MIPv6 Option - Restart Counter	Restart Counter	mip6.options.rc
RFC 7468 file format	rfc7468	rfc7468
Exchange 2003 Directory Request For Response	RFR	rfr
RFtap Protocol	RFtap	rftap
Router-port Group Management Protocol	RGMP	rgmp
Riemann	Riemann	riemann
Routing Information Protocol	RIP	rip
RIPng	RIPng	ripng
TCP Option - Riverbed Probe	Riverbed Probe	tcp.options.rvbd.probe
TCP Option - Riverbed Transparency	Riverbed Transparency	tcp.options.rvbd.trpy
Radio Link Control	RLC	rlc
RLC-LTE	RLC-LTE	rlc-lte
RLC-NR	RLC-NR	rlc-nr
Redundant Link Management Protocol	RLM	rlm
Rlogin Protocol	Rlogin	rlogin
Remote Management Control Protocol	RMCP	rmcp
Java RMI	RMI	rmi
HP Remote Maintenance Protocol	RMP	rmp
Forward Error Correction (FEC)	RMT-FEC	rmt-fec
Layered Coding Transport	RMT-LCT	rmt-lct
UTRAN Iur interface Radio Network Subsystem Application Part	RNSAP	rnsap
RObust Header Compression (ROHC)	ROHC	rohc
Roofnet Protocol	Roofnet	roofnet
X.880 OSI Remote Operations Service	ROS	ros
IP Option - Router Alert	Router Alert	ip.options.routeralert
Remote Override interface	roverride	roverride
Remote Procedure Call	RPC	rpc
RPC Browser	RPC_BROWSER	rpc_browser
Microsoft Network Logon	RPC_NETLOGON	rpc_netlogon
Remote Packet Capture	RPCAP	rpcap
RPC over RDMA	RPCoRDMA	rpcordma
RPKI-Router Protocol	RPKI-Router Protocol	rpkirtr
Remote Program Load	RPL	rpl
IPv6 Routing Type - RPL Source Route	RPL Source Route	ipv6.routing.type.mipv6
Privilege Server operations	rpriv	rpriv
Remote Quota	RQUOTA	rquota
Microsoft Routing and Remote Access Service	RRAS	rras
Radio Resource Control (RRC) protocol	RRC	rrc
Radio Resource LCS Protocol (RRLP)	RRLP	rrlp
DCE/RPC RS_ACCT	RS_ACCT	rs_acct
Registry Server Attributes Manipulation Interface	RS_ATTR	rs_attr
DCE/RPC Registry Server Attributes Schema	rs_attr_schema	rs_attr_schema
DCE/RPC RS_BIND	RS_BIND	rs_bind
DCE/RPC RS_MISC	rs_misc	rs_misc
DCE Name Service	RS_PGO	rs_pgo
RS Interface properties	RS_PLCY	rs_plcy
DCE/RPC RS_PROP_ACCT	rs_prop_acct	rs_prop_acct
DCE/RPC Registry server propagation interface - ACLs	rs_prop_acl	rs_prop_acl
DCE/RPC Prop Attr	rs_prop_attr	rs_prop_attr
DCE/RPC Registry server propagation interface - PGO items	rs_prop_pgo	rs_prop_pgo
DCE/RPC Registry server propagation interface - properties and policies	rs_prop_plcy	rs_prop_plcy
DCE/RPC Registry Password Management	rs_pwd_mgmt	rs_pwd_mgmt
Registry server administration operations.	RS_REPADM	rs_repadm
DCE/RPC Repserver Calls	RS_REPLIST	rs_replist
DCE/RPC Operations between registry server replicas	rs_repmgr	rs_repmgr
DCE/RPC RS_UNIX	RS_UNIX	rs_unix
Remote sec_login preauth interface.	rsec_login	rsec_login
Remote Shell	RSH	rsh
Realm Specific IP Protocol	RSIP	rsip
Radio Signalling Link (RSL)	RSL	gsm_abis_rsl
RMCP Security-extensions Protocol	RSP	rsp
rss	rss	rss
RSTAT	RSTAT	rstat
Remote Shared Virtual Disk	RSVD	rsvd
Resource ReserVation Protocol (RSVP)	RSVP	rsvp
Resource ReserVation Protocol (RSVP-E2EI)	RSVP-E2EI	rsvp-e2ei
RSYNC File Synchroniser	RSYNC	rsync
RTAC Serial	RTAC Serial	rtacser
WebRTC Datachannel Protocol	RTCDC	rtcdc
RTcfg	RTcfg	rtcfg
ITS message - RTCMEM	RTCMEM	its.message.rtcmem
Real-time Transport Control Protocol	RTCP	rtcp
RTI TCP Transport Protocol	RTITCP	rtitcp
Real Time Location System	RTLS	rtls
Real-Time Media Access Control	RTmac	rtmac
Routing Table Maintenance Protocol	RTMP	rtmp
Real Time Messaging Protocol	RTMPT	rtmpt
Linux rtnetlink (route netlink) protocol	rtnetlink	netlink-route
Real-Time Transport Protocol	RTP	rtp
RTP compression (RFC2508)	RTP compression (RFC2508)	ipcp.opt.iphc.rtp_compress
RFC 2833 RTP Event	RTP Event	rtpevent
Real-Time Transport Protocol ED137 Extensions	RTP-ED137	rtp.ext.ed137
RFC 4695/6295 RTP-MIDI	RTP-MIDI	rtpmidi
Sippy RTPproxy Protocol	RTPproxy	rtpproxy
Real-Time Publish-Subscribe Wire Protocol	RTPS	rtps
Real-Time Publish-Subscribe Wire Protocol (processed)	RTPS-PROC	rtpsproc
Real-Time Publish-Subscribe Virtual Transport	RTPS-VT	rtpsvt
X.228 OSI Reliable Transfer Service	RTSE	rtse
Real Time Streaming Protocol	RTSP	rtsp
UTRAN Iuh interface RUA signalling	RUA	rua
Reliable UDP	RUDP	rudp
Remote Wall protocol	RWALL	rwall
RX Protocol	RX	rx
S101	S101	s101
S1 Application Protocol	S1AP	s1ap
S7 Communication	S7COMM	s7comm
UTRAN IuBC interface SABP signaling	SABP	sabp
TCP Option - SACK	SACK	tcp.options.sack
TCP Option - SACK permitted	SACK permitted	tcp.options.sack_perm
SADMIND	SADMIND	sadmind
Sametime Protocol	SAMETIME	sametime
SAMIS-TYPE-1 Record	SAMIS-TYPE-1 Record	ipdr_samis_type_1
SAMR (pidl)	SAMR	samr
Session Announcement Protocol	SAP	sap
Server/Application State Protocol	SASP	sasp
SAToP (no RTP support)	SAToP (no RTP)	pwsatopcw
Bluetooth SBC Codec	SBC	sbc
SBc Application Part	SBcAP	sbcap
SAIA S-Bus	SBUS	sbus
Signalling Connection Control Part	SCCP	sccp
Signalling Connection Control Part Management	SCCPMG	sccpmg
ZigBee SCoP	SCoP	scop
TCP Option - SCPS capabilities	SCPS capabilities	tcp.options.scps
TCP Option - SCPS corruption experienced	SCPS corruption experienced	tcp.options.scpscor
TCP Option - SCPS record boundary	SCPS record boundary	tcp.options.scpsrec
SCSI	SCSI	scsi
SCSI_MMC	SCSI_MMC	scsi_mmc
SCSI_OSD	SCSI_OSD	scsi_osd
SCSI_SBC	SCSI_SBC	scsi_sbc
SCSI_SMC	SCSI_SMC	scsi_smc
SCSI_SSC	SCSI_SSC	scsi_ssc
SCTE-35 Splice Information	SCTE 35	scte35
SCTE-35 Private Command	SCTE35 PC	scte35_private_command
SCTE-35 Splice Insert	SCTE35 SI	scte35_si
SCTE-35 Splice Schedule	SCTE35 SS	scte35_splice_schedule
SCTE-35 Time Signal	SCTE35 TS	scte35_time
Stream Control Transmission Protocol	SCTP	sctp
Scylla RPC protocol	Scylla	scylla
SDAP	SDAP	sdap
SDH/SONET Protocol	SDH	sdh
Synchronous Data Link Control (SDLC)	SDLC	sdlc
Session Description Protocol	SDP	sdp
SEBEK - Kernel Data Capture	SEBEK	sebek
DCE Security ID Mapper	SECIDMAP	secidmap
Secondary DNS Server IP Address	Secondary DNS Server IP Address	ipcp.opt.sec_dns
Secondary NBNS Server IP Address	Secondary NBNS Server IP Address	ipcp.opt.sec_nbns
IP Option - Security	Security	ip.options.security
IPv6 Routing Types - Segment Routing	Segment Routing	ipv6.routing.type.srh
SEL Protocol	SEL Protocol	selfm
IP Option - Selective Directed Broadcast	Selective Directed Broadcast	ip.options.sdb
TCP Option - Selective Negative Acknowledgment	Selective Negative Acknowledgment	tcp.options.snack
Self Describing Pad	Self Describing Pad	lcp.opt.self_desc_pad
SERCOS III V1.1	SERCOS III V1.1	siii
Java Serialization	Serialization	serialization
MIPv6 Option - Service Selection	Service Selection	mip6.options.ssm
ISO 8327-1 OSI Session Protocol	SES	ses
InMon sFlow	sFlow	sflow
SGI Mount Service	SGI MOUNT	sgimount
SGs Application Part (SGsAP)	SGSAP	sgsap
Shim6 Protocol	Shim6	shim6
Short Frame	Short frame	_ws.short
Signaling Compression	SIGCOMP	sigcomp
Signal PDU	Signal PDU	signal_pdu
MIPv6 Option - Signature	Signature	mip6.options.sign
Standard Interface for Multiple Platform Link Evaluation	SIMPLE	simple
Simple Data Link on SONET/SDH	Simple Data Link on SONET/SDH	lcp.opt.sonet_sdh
SIMULCRYPT Protocol	SIMULCRYPT	simulcrypt
Session Initiation Protocol	SIP	sip
Sipfrag	SIPFRAG	sipfrag
Serial Infrared	SIR	sir
Societe Internationale de Telecommunications Aeronautiques	SITA	sita
Skinny Client Control Protocol	SKINNY	skinny
SKYPE	SKYPE	skype
Cisco SLARP	SLARP	slarp
SliMP3 Communication Protocol	SliMP3	slimp3
Linux cooked-mode capture	SLL	sll
Cisco Session Management	SM	sm
SMB (Server Message Block Protocol)	SMB	smb
SMB MailSlot Protocol	SMB Mailslot	mailslot
SMB Pipe Protocol	SMB Pipe	smb_pipe
SMB2 (Server Message Block Protocol version 2)	SMB2	smb2
Microsoft Windows Logon Protocol (Old)	SMB_NETLOGON	smb_netlogon
SMB-Direct (SMB RDMA Transport)	SMBDirect	smb_direct
Shared Memory Communications	SMC	smc
Synchronized Multimedia Integration Language	smil	smil
Smart Message Language	SML	sml
Session Multiplex Protocol	SMP	smp
Short Message Peer to Peer	SMPP	smpp
Short Message Relaying Service	SMRSE	smrse
Simple Mail Transfer Protocol	SMTP	smtp
SNMP Multiplex Protocol	SMUX	smux
Systems Network Architecture	SNA	sna
Systems Network Architecture XID	SNA XID	sna_xid
SNA-over-Ethernet	SNAETH	snaeth
Subnetwork Dependent Convergence Protocol	SNDCP	sndcp
Subnetwork Dependent Convergence Protocol XID	SNDCP XID	sndcpxid
Simple Network Management Protocol	SNMP	snmp
Snort Alerts	Snort	snort
Linux netlink sock diag protocol	sock_diag	netlink-sock_diag
Socks Protocol	Socks	socks
SolarEdge monitoring protocol	SolarEdge	solaredge
SOME/IP Protocol	SOME/IP	someip
SOME/IP Service Discovery Protocol	SOME/IP-SD	someipsd
SoulSeek Protocol	SoulSeek	slsk
SoupBinTCP	SoupBinTCP	soupbintcp
IPv6 Routing Type - Source Route	Source Route	ipv6.routing.type.rt0
Spanning-Tree-Protocol (old formatted)	Spanning-Tree-Protocol (old formatted)	bcp_ncp.opt.stp
SparkplugB	SparkplugB	sparkplugb
ITS message - SPATEM	SPATEM	its.message.spatem
ITS message - SPATEMv1	SPATEMv1	its.message.spatemv1
SPDY	SPDY	spdy
Spice protocol	Spice	spice
Simple Protected Negotiation	SPNEGO	spnego
SPNEGO-KRB5	SPNEGO-KRB5	spnego-krb5
Microsoft Spool Subsystem	SPOOLSS	spoolss
Sequenced Packet Protocol	SPP	spp
SPRAY	SPRAY	spray
Simple Packet Relay Transport	SPRT	sprt
Sequenced Packet eXchange	SPX	spx
ITS message - SREM	SREM	its.message.srem
H.324/SRP	SRP	srp
SRT Protocol	SRT	srt
Service Location Protocol	SRVLOC	srvloc
Server Service	SRVSVC	srvsvc
SSCF-NNI	SSCF-NNI	sscf-nni
SSCOP	SSCOP	sscop
Simple Service Discovery Protocol	SSDP	ssdp
ITS message - SSEM	SSEM	its.message.ssem
SSH Protocol	SSH	ssh
Scripting Service Protocol	SSP	ssp
Novell SecretStore Services	SSS	sss
Secure Socket Tunneling Protocol	SSTP	sstp
State Synchronization Protocol	SSyncP	ssyncp
Stac Electronics LZS	Stac Electronics LZS	ccp.opt.stac
Stac Electronics LZS (Ascend Proprietary version)	Stac Electronics LZS (Ascend Proprietary version)	ccp.opt.stac_ascend
STANAG 4607 (GMTI Format)	STANAG 4607	s4607
STANAG 5066(DTS layer)	STANAG 5066 DTS	s5066dts
STANAG 5066 (SIS layer)	STANAG 5066 SIS	s5066sis
StarTeam	StarTeam	starteam
Network Status Monitor Protocol	STAT	stat
Network Status Monitor CallBack Protocol	STAT-CB	statnotify
Spirent Test Center Signature	STCSIG	stcsig
Steam In-Home Streaming Discovery Protocol	Steam IHS Discovery	steam_ihs_discovery
Spanning Tree Protocol	STP	stp
IP Option - Stream ID	Stream ID	ip.options.sid
IP Option - Strict Source Route	Strict Source Route	ip.options.source_route
String Errors	String errors	_ws.string
Stateless Transport Tunneling	STT	stt
Session Traversal Utilities for NAT	STUN	stun
SS7 SCCP-User Adaptation Layer	SUA	sua
IEC61850 Sampled Values	SV	sv
Microsoft Service Control	SVCCTL	svcctl
SVR4	svr4	nfs.svr4
swIPe IP Security Protocol	swIPe	swipe
Symantec Enterprise Firewall	Symantec	symantec
MBMS synchronisation protocol	SYNC	sync
DOCSIS Synchronisation Message	SYNC Message	docsis_sync
IEEE C37.118 Synchrophasor Protocol	SYNCHROPHASOR	synphasor
Synergy	Synergy	synergy
System Call	Syscall	syscall
Sysdig System Call	Sysdig Event	sysdig
MIDI System Exclusive	SYSEX	sysex
MIDI System Exclusive DigiTech	SYSEX DigiTech	sysex_digitech
Syslog message	Syslog	syslog
systemd Journal Entry	systemd Journal	systemd_journal
GENERIC-CONFERENCE-CONTROL T.124	T.124	t124
MULTIPOINT-COMMUNICATION-SERVICE T.125	T.125	t125
T.30	T.30	t30
T.38	T.38	t38
TACACS	TACACS	tacacs
TACACS+	TACACS+	tacplus
Transport Adapter Layer Interface v1.0, RFC 3094	TALI	tali
Tango Dissector Using GIOP API	TANGO	giop-tango
Trapeze Access Point Access Protocol	TAPA	tapa
Microsoft Telephony API Service	TAPI	tapi
Microsoft Task Scheduler Service	TaskSchedulerService	taskschedulerservice
TwinCAT NV	TC-NV	tc_nv
Transaction Capabilities Application Part	TCAP	tcap
TCG_CP_OIDS	TCG_CP_OIDS	tcg_cp_oids
Transmission Control Protocol	TCP	tcp
TCP Option - TCP AO	TCP AO	tcp.options.ao
TCP Option - TCP Fast Open	TCP Fast Open	tcp.options.tfo
TCP Option - TCP MD5 signature	TCP MD5 signature	tcp.options.md5
DTN TCP Convergence Layer Protocol	TCPCL	tcpcl
TCP Encapsulation of IPsec Packets	TCPENCAP	tcpencap
TCP based Robot Operating System protocol (TCPROS)	TCPROS	tcpros
TDMA RTmac Discipline	TDMA	tdma
Digium TDMoE Protocol	TDMoE	tdmoe
TDMoP protocol	TDMoP	tdmop
Tabular Data Stream	TDS	tds
Teamspeak2 Protocol	TeamSpeak2	ts2
Tunnel Extensible Authentication Protocol	TEAP	teap
Technically Enhanced Capture Module Protocol	TECMP	tecmp
Technically Enhanced Capture Module Protocol Payload	TECMP Payload	tecmp.payload
TEI Management Procedure, Channel D (LAPD)	TEI_MANAGEMENT	tei_management
TEKLINK	TEKLINK	teklink
Telkonet powerline	TELKONET	telkonet
Telnet	TELNET	telnet
Teredo IPv6 over UDP tunneling	Teredo	teredo
TETRA Protocol	TETRA	tetra
Tinkerforge Protocol	TFP	tfp
Trivial File Transfer Protocol	TFTP	tftp
Thread	Thread	thread
Thread Address	Thread Address	thread_address
Thread Beacon	Thread Beacon	thread_bcn
Thread CoAP	Thread CoAP	thread_coap
Thread Diagnostics	Thread Diagnostics	thread_diagnostic
Thread MeshCoP	Thread MeshCoP	thread_meshcop
Thread Network Data	Thread NWD	thread_nwd
Thrift Protocol	Thrift	thrift
Tibia Protocol	Tibia	tibia
Tagged Image File Format	TIFF image	tiff
Time Protocol	TIME	time
IP Option - Time Stamp	Time Stamp	ip.options.timestamp
MIPv6 Option - Timestamp	Timestamp	mip6.options.ts
TCP Option - Timestamps	Timestamps	tcp.options.timestamp
Tinygram-Compression	Tinygram-Compression	bcp_ncp.opt.tinygram_comp
Transparent Inter Process Communication(TIPC)	TIPC	tipc
ITS message - TISTPG	TISTPG	its.message.tistpg
TiVoConnect Discovery Protocol	TiVoConnect	tivoconnect
DCE DFS Token Server	TKN4Int	tkn4int
Transport Layer Security	TLS	tls
Serial Terminal Mode Interface	TMode	tmode
TN3270 Protocol	TN3270	tn3270
TN5250 Protocol	TN5250	tn5250
Transport-Neutral Encapsulation Format	TNEF	tnef
Transparent Network Substrate Protocol	TNS	tns
Token-Ring	Token-Ring	tr
Alteon - Transparent Proxy Cache Protocol	TPCP	tpcp
TPKT - ISO on TCP - RFC1006	TPKT	tpkt
TP-Link Smart Home Protocol	TPLINK-SMARTHOME	tplink-smarthome
TPM2.0 Protocol	TPM2.0	tpm
AudioCodes TPNCP (TrunkPack Network Control Protocol)	TPNCP	tpncp
Token-Ring Media Access Control	TR MAC	trmac
IP Option - Traceroute	Traceroute	ip.options.traceroute
TRANSUM RTE Data	TRANSUM	transum
TRILL	TRILL	trill
Microsoft Distributed Link Tracking Server Service	TRKSVR	trksvr
Time-Synchronous Control Format	TSCF	tscf
TeamSpeak3 DNS	TSDNS	tsdns
Time Synchronization Protocol	TSP	tsp
TTEthernet	TTE	tte
TTEthernet Protocol Control Frame	TTE PCF	tte_pcf
Tiny Transport Protocol	TTP	ttp
Turbocell Header	Turbocell	turbocell
Turbocell Aggregate Data	Turbocell Aggregate Data	turbocell_aggregate
TURN Channel	TURNCHANNEL	turnchannel
BEA Tuxedo	TUXEDO	tuxedo
TwoWay Active Measurement Control Protocol	TWAMP-Control	twamp.control
TwoWay Active Measurement Test Protocol	TWAMP-Test	twamp.test
IPv6 Routing Type - Type 2	Type 2	ipv6.routing.type.mipv6
Type Length Mismatch	Type length mismatch	_ws.type_length
Tazmen Sniffer Protocol	TZSP	tzsp
USB 3 Vision	U3V	u3v
Universal Alcatel Protocol	UA	ua
UA3G Message	UA3G	ua3g
UA/SIP Protocol	UASIP	uasip
UA/UDP Encapsulation Protocol	UAUDP	uaudp
UAVCAN/CAN	UAVCAN/CAN	uavcan_can
Ubiquiti Discovery Protocol	UBDP	ubdp
Ubertooth	UBERTOOTH	ubertooth
DCE DFS FLDB UBIK TRANSFER	UBIKDISK	ubikdisk
DCE DFS FLDB UBIKVOTE	UBIKVOTE	ubikvote
Universal Computer Protocol	UCP	ucp
Unidirectional Link Detection	UDLD	udld
User Datagram Protocol	UDP	udp
Lightweight User Datagram Protocol	UDP-Lite	udplite
UDPCP	UDPCP	udpcp
UDP Encapsulation of IPsec Packets	UDPENCAP	udpencap
Unified Diagnostic Services	UDS	uds
UDT Protocol	UDT	udt
UDP based FTP w/ multicast	UFTP	uftp
UDP based FTP w/ multicast V4	UFTP4	uftp4
UDP based FTP w/ multicast V5	UFTP5	uftp5
UHD	UHD	uhd
OMA UserPlane Location Protocol	ULP	ulp
Unlicensed Mobile Access	UMA	uma
UNISTIM Protocol	UNISTIM	unistim
TCP Option - Unknown	Unknown	tcp.options.unknown
Unknown	unknown	nfs.unknown
Unreassembled Fragmented Packet	Unreassembled fragmented packet	_ws.unreassembled
HTML Form URL Encoded	URL Encoded Form Data	urlencoded-form
USB	USB	usb
USB Device Firmware Upgrade 	USB DFU	usbdfu
USB Audio	USBAUDIO	usbaudio
USB CCID	USBCCID	usbccid
USB Communications and CDC Control	USBCOM	usbcom
USB HID	USBHID	usbhid
USB HUB	USBHUB	usbhub
USBIP Protocol	USBIP	usbip
USB Link Layer	USBLL	usbll
USB Mass Storage	USBMS	usbms
USBPort	USBPort	usbport
USB Printer	USBPRINTER	usbprinter
USB Video	USBVIDEO	usbvideo
TCP Option - User Timeout	User Timeout	tcp.options.user_to
UserLog Protocol	UserLog	userlog
Unisys Transmittal System	UTS	uts
Async data over ISDN (V.120)	V.120	v120
V.150.1 State Signaling Event	V.150.1 SSE	v150fw
V.42bis compression	V.42bis compression	ccp.opt.v42bis
V.44/LZJH compression	V.44/LZJH compression	ccp.opt.v44lzjh
V5.2	V5.2	v52
V5 Data Link Layer	V5DL	v5dl
V5 Envelope Function (v5ef)	v5ef	v5ef
V5.2-User Adaptation Layer	V5UA	v5ua
VCDU	VCDU	vcdu
VSI protocol	VDP21	vdp21
MIPv6 Option - Vendor Specific	Vendor Specific	mip6.options.vsm
Vendor Specific	Vendor Specific	lcp.opt.vendor
AMQP Version 0.10	Version 0.10	amqp.version.v0_10
AMQP Version 0.9	Version 0.9	amqp.version.v0_9
AMQP Version 1.0	Version 1.0	amqp.version.v1_0
LeCroy VICP	VICP	vicp
VINES	VINES	vines
Banyan Vines ARP	Vines ARP	vines_arp
Banyan Vines Echo	Vines Echo	vines_echo
Banyan Vines Fragmentation Protocol	Vines FRP	vines_frp
Banyan Vines ICP	Vines ICP	vines_icp
Banyan Vines IP	Vines IP	vines_ip
Banyan Vines IPC	Vines IPC	vines_ipc
Banyan Vines LLC	Vines LLC	vines_llc
Banyan Vines RTP	Vines RTP	vines_rtp
Banyan Vines SPP	Vines SPP	vines_spp
VITA 49 radio transport protocol	VITA 49	vrt
Van Jacobson PPP compression	VJC	vjc
802.1Q Virtual LAN	VLAN	vlan
VMware Lab Manager	VMLAB	vmlab
Virtual Network Computing	VNC	vnc
VN-Tag	VNTAG	vntag
VP8	VP8	vp8
VPP Dispatch Trace	VPP	vpp
VPP Buffer Metadata	VPP-Metadata	vpp-metadata
VPP Buffer Opaque	VPP-Opaque	vpp-opaque
VPP Buffer Opaque2	VPP-Opaque2	vpp-opaque2
VPP Buffer Trace	VPP-Trace	vpp-trace
Virtual Router Redundancy Protocol	VRRP	vrrp
Video Services over IP	VSIP	vsip
Vendor Specific Control Protocol	VSNCP	vsncp
vSocket	vsock	vsock
VSS Monitoring Ethernet trailer	VSS Monitoring	vssmonitoring
VLAN Trunking Protocol	VTP	vtp
Vuze DHT Protocol	Vuze-DHT	vuze-dht
VXI-11 Asynchronous Abort	VXI-11 Async	vxi11_async
VXI-11 Core Protocol	VXI-11 Core	vxi11_core
VXI-11 Interrupt	VXI-11 Intr	vxi11_intr
Virtual eXtensible Local Area Network	VXLAN	vxlan
Virtual eXtensible Local Area Network (GPE)	VXLAN (GPE)	vxlan_gpe
WAI Protocol	WAI	wai
WAP Session Initiation Request	WAP SIR	wap-sir
Wireless Access Station Session Protocol	WASSP	wassp
watcherinfo XML doc (RFC 3858)	watcherinfo	watcherinfo
WaveAgent	waveagent	waveagent
WAP Binary XML	WBXML	wbxml
Web Cache Communication Protocol	WCCP	wccp
Wellfleet Compression	WCP	wcp
WebSocket	WebSocket	websocket
Wi-Fi Display	WFD	wifi_display
Wellfleet HDLC	WHDLC	whdlc
Who	WHO	who
whois	WHOIS	whois
Wi-Fi Device Provisioning Protocol	Wi-Fi DPP	dpp
Wi-Fi Peer-to-Peer	Wi-Fi P2P	wifi_p2p
Wi-SUN Field Area Network	Wi-SUN	wisun
Wi-SUN FAN EAPOL Relay	Wi-SUN EAPOL Relay	wisun.eapol_relay
Wi-SUN Netricity Segment	Wi-SUN Netricity Segment	wisun.netricity.sc
Wi-SUN FAN Security Extension	Wi-SUN WM-SEC	wisun.sec
WiMax Protocol	WiMax (wmx)	wmx
WiMax AAS-BEAM Messages	WiMax AAS-BEAM	wmx.aas_beam
WiMax AAS-FEEDBACK Messages	WiMax AAS-FEEDBACK (aas)	wmx.aas
WiMax ARQ Feedback/Discard/Reset Messages	WiMax ARQ Feedback/Discard/Reset (arq)	wmx.arq
WiMAX ASN Control Plane Protocol	WiMAX ASN CP	wimaxasncp
WiMax CLK-CMP Message	WiMax CLK-CMP (clk)	wmx.clk
WiMax DCD Messages	WiMax DCD	wmx.dcd
WiMax DLMAP Messages	WiMax DLMAP	wmx.dlmap
WiMax DREG-CMD Messages	WiMax DREG-CMD	wmx.dreg_cmd
WiMax DREG-REQ Messages	WiMax DREG-REQ	wmx.dreg_req
WiMax DSA Messages	WiMax DSA	wmx.dsa
WiMax DSC Messages	WiMax DSC	wmx.dsc
WiMax DSD Messages	WiMax DSD	wmx.dsd
WiMax DSX-RVD Message	WiMax DSX-RVD (dsx_rvd)	wmx.dsx_rvd
WiMax FPC Message	WiMax FPC (fpc)	wmx.fpc
WiMax Generic/Type1/Type2 MAC Header Messages	WiMax Generic/Type1/Type2 MAC Header (hdr)	wmx.hdr
WiMAX MAC-PHY over Ethernet	WiMAX MAC-PHY	wimaxmacphy
WiMax PKM-REQ/RSP Messages	WiMax PKM-REQ/RSP (pkm)	wmx.pkm
WiMax PMC-REQ Messages	WiMax PMC-REQ	wmx.pmc_req
WiMax PMC-RSP Messages	WiMax PMC-RSP	wmx.pmc_rsp
WiMax PRC-LT-CTRL Message	WiMax PRC-LT-CTRL (prc)	wmx.prc
WiMax REG-REQ Messages	WiMax REG-REQ	wmx.reg_req
WiMax REG-RSP Messages	WiMax REG-RSP	wmx.reg_rsp
WiMax REP-REQ/RSP Messages	WiMax REP-REQ/RSP (rep)	wmx.rep
WiMax RES-CMD Message	WiMax RES-CMD (res)	wmx.res
WiMax RNG-REQ Messages	WiMax RNG-REQ	wmx.rng_req
WiMax RNG-RSP Messages	WiMax RNG-RSP	wmx.rng_rsp
WiMax SBC-REQ/RSP Messages	WiMax SBC-REQ/RSP (sbc)	wmx.sbc
WiMax Sub-TLV Messages	WiMax Sub-TLV (sub)	wmx.sub
WiMax UCD Messages	WiMax UCD	wmx.ucd
WiMax ULMAP Messages	WiMax ULMAP	wmx.ulmap
TCP Option - Window scale	Window scale	tcp.options.wscale
Remote Registry Service	WINREG	winreg
WINS (Windows Internet Name Service) Replication	WINS-Replication	winsrepl
WireGuard Protocol	WireGuard	wg
SMB Witness Service	WITNESS	witness
Workstation Service	WKSSVC	wkssvc
Wlan Certificate Extension	WLANCERTEXTN	wlancertextn
Cisco Wireless LAN Context Control Protocol	WLCCP	wlccp
Wake On LAN	WOL	wol
World of Warcraft	WOW	wow
World of Warcraft World	WOWW	woww
Wifi Protected Setup	WPS	wps
WSE remote ethernet	WRETH	wreth
Wave Short Message Protocol(IEEE P1609.3)	WSMP	wsmp
Wireless Session Protocol	WSP	wsp
Wireless Transport Layer Security	WTLS	wtls
Wireless Transaction Protocol	WTP	wtp
Wireless Configuration Service	WZCSVC	wzcsvc
X-Rite i1 Display Pro (and derivatives) USB protocol	X-Rite i1 Display Pro	i1d3
X.25	X.25	x25
X.29	X.29	x29
X11	X11	x11
EUTRAN X2 Application Protocol (X2AP)	X2AP	x2ap
X.509 Authentication Framework	X509AF	x509af
X.509 Certificate Extensions	X509CE	x509ce
X.509 Information Framework	X509IF	x509if
X.509 Selected Attribute Types	X509SAT	x509sat
XML Configuration Access Protocol Server Capabilities	xcap-caps	xcap-caps
XCAP Error XML doc (RFC 4825)	xcap-error	xcap-error
Call Specification Language (Xcsl)	XCSL	xcsl
X Display Manager Control Protocol	XDMCP	xdmcp
eXpressive Internet Protocol	XIP	xip
XIP Serval	XIP Serval	xipserval
X2 xIRI payload	xIRI	xiri
eXtensible Messaging Client Protocol	XMCP	xmcp
eXtensible Markup Language	XML	xml
XMPP Protocol	XMPP	xmpp
NG-RAN Xn Application Protocol (XnAP)	XnAP	xnap
X.25 over TCP	XOT	xot
Excentis XRA Header	XRA	xra
Xpress Transport Protocol	XTP	xtp
Xyplex	XYPLEX	xyplex
YAMI Protocol	YAMI	yami
Yahoo Messenger Protocol	YHOO	yhoo
Yahoo YMSG Messenger Protocol	YMSG	ymsg
Yellow Pages Bind	YPBIND	ypbind
Yellow Pages Passwd	YPPASSWD	yppasswd
Yellow Pages Service	YPSERV	ypserv
Yellow Pages Transfer	YPXFR	ypxfr
Z39.50 Protocol	Z39.50	z3950
ZBOSS IEEE 802.15.4 dump	ZBOSS dump	wpan-zboss
ZigBee ZCL Alarms	ZCL Alarms	zbee_zcl_general.alarms
ZigBee ZCL Analog Input Basic	ZCL Analog Input Basic	zbee_zcl_general.analog.input.basic
ZigBee ZCL Analog Output Basic	ZCL Analog Output Basic	zbee_zcl_general.analog.output.basic
ZigBee ZCL Analog Value Basic	ZCL Analog Value Basic	zbee_zcl_general.analog.value.basic
ZigBee ZCL Appliance Control	ZCL Appliance Control	zbee_zcl_general.applctrl
ZigBee ZCL Appliance Events & Alert	ZCL Appliance Events & Alert	zbee_zcl_ha.applevtalt
ZigBee ZCL Appliance Identification	ZCL Appliance Identification	zbee_zcl_ha.applident
ZigBee ZCL Appliance Statistics	ZCL Appliance Statistics	zbee_zcl_ha.applstats
ZigBee ZCL Ballast Configuration	ZCL Ballast Configuration	zbee_zcl_lighting.ballast_ctrl
ZigBee ZCL Basic	ZCL Basic	zbee_zcl_general.basic
ZigBee ZCL Binary Input Basic	ZCL Binary Input Basic	zbee_zcl_general.binary_input_basic
ZigBee ZCL Binary Output Basic	ZCL Binary Output Basic	zbee_zcl_general.binary_output_basic
ZigBee ZCL Binary Value Basic	ZCL Binary Value Basic	zbee_zcl_general.binary_value_basic
ZigBee ZCL Calendar	ZCL Calendar	zbee_zcl_se.calendar
ZigBee ZCL Color Control	ZCL Color Control	zbee_zcl_lighting.color_ctrl
ZigBee ZCL Commissioning	ZCL Commissioning	zbee_zcl_general.commissioning
ZigBee ZCL Daily Schedule	ZCL Daily Schedule	zbee_zcl_se.daily_schedule
ZigBee ZCL Dehumidification Control	ZCL Dehumidification Control	zbee_zcl_hvac.dehum_ctrl
ZigBee ZCL Device Management	ZCL Device Management	zbee_zcl_se.dm
ZigBee ZCL Device Temperature Configuration	ZCL Device Temperature Configuration	zbee_zcl_general.device_temperature_config
ZigBee ZCL DLRC	ZCL DLRC	zbee_zcl_se.drlc
ZigBee ZCL Door Lock	ZCL Door Lock	zbee_zcl_closures.door_lock
ZigBee ZCL Electrical Measurement	ZCL Electrical Measurement	zbee_zcl_meas_sensing.elecmes
ZigBee ZCL Energy Management	ZCL Energy Management	zbee_zcl_se.em
ZigBee ZCL Events	ZCL Events	zbee_zcl_se.events
ZigBee ZCL Fan Control	ZCL Fan Control	zbee_zcl_hvac.fan_ctrl
ZigBee ZCL Flow Meas.	ZCL Flow Meas.	zbee_zcl_meas_sensing.flowmeas
ZigBee ZCL Green Power	ZCL Green Power	zbee_zcl_general.gp
ZigBee ZCL Groups	ZCL Groups	zbee_zcl_general.groups
ZigBee ZCL IAS ACE	ZCL IAS ACE	zbee_zcl_ias.ace
ZigBee ZCL IAS WD	ZCL IAS WD	zbee_zcl_ias.wd
ZigBee ZCL IAS Zone	ZCL IAS Zone	zbee_zcl_ias.zone
ZigBee ZCL Identify	ZCL Identify	zbee_zcl_general.identify
ZigBee ZCL Illuminance Level Sensing	ZCL Illuminance Level Sensing	zbee_zcl_meas_sensing.illumlevelsen
ZigBee ZCL Illuminance Meas.	ZCL Illuminance Meas.	zbee_zcl_meas_sensing.illummeas
ZigBee ZCL Keep-Alive	ZCL Keep-Alive	zbee_zcl_se.keep_alive
ZigBee ZCL Key Establishment	ZCL Key Establishment	zbee_zcl_se.ke
ZigBee ZCL Level Control	ZCL Level Control	zbee_zcl_general.level_control
ZigBee ZCL MDU Pairing	ZCL MDU Pairing	zbee_zcl_se.mdu_pairing
ZigBee ZCL Messaging	ZCL Messaging	zbee_zcl_se.msg
ZigBee ZCL Meter Identification	ZCL Meter Identification	zbee_zcl_ha.metidt
ZigBee ZCL Metering	ZCL Metering	zbee_zcl_se.met
ZigBee ZCL Multistate Input Basic	ZCL Multistate Input Basic	zbee_zcl_general.multistate.input.basic
ZigBee ZCL Multistate Output Basic	ZCL Multistate Output Basic	zbee_zcl_general.multistate.output.basic
ZigBee ZCL Multistate Value Basic	ZCL Multistate Value Basic	zbee_zcl_general.multistate.value.basic
ZigBee ZCL Occupancy Sensing	ZCL Occupancy Sensing	zbee_zcl_meas_sensing.occsen
ZigBee ZCL OnOff	ZCL OnOff	zbee_zcl_general.onoff
ZigBee ZCL OnOff Switch Configuration	ZCL OnOff Switch Configuration	zbee_zcl_general.onoff.switch.configuration
ZigBee ZCL OTA	ZCL OTA	zbee_zcl_general.ota
ZigBee ZCL Partition	ZCL Partition	zbee_zcl_general.part
ZigBee ZCL Poll Control	ZCL Poll Control	zbee_zcl_general.poll
ZigBee ZCL Power Configuration	ZCL Power Configuration	zbee_zcl_general.power_config
ZigBee ZCL Power Profile	ZCL Power Profile	zbee_zcl_general.pwrprof
ZigBee ZCL Prepayment	ZCL Prepayment	zbee_zcl_se.pp
ZigBee ZCL Pressure Meas.	ZCL Pressure Meas.	zbee_zcl_meas_sensing.pressmeas
ZigBee ZCL Price	ZCL Price	zbee_zcl_se.price
ZigBee ZCL Pump Configuration and Control	ZCL Pump Configuration and Control	zbee_zcl_hvac.pump_config_ctrl
ZigBee ZCL Rel. Humidity Meas.	ZCL Relative Humidity Meas.	zbee_zcl_meas_sensing.relhummeas
ZigBee ZCL RSSI Location	ZCL RSSI Location	zbee_zcl_general.rssi_location
ZigBee ZCL Scenes	ZCL Scenes	zbee_zcl_general.scenes
ZigBee ZCL Shade Configuration	ZCL Shade Configuration	zbee_zcl_closures.shade_config
ZigBee ZCL Sub-Ghz	ZCL Sub-Ghz	zbee_zcl_se.sub_ghz
ZigBee ZCL Temperature Meas.	ZCL Temperature Meas.	zbee_zcl_meas_sensing.tempmeas
ZigBee ZCL Thermostat	ZCL Thermostat	zbee_zcl_hvac.thermostat
ZigBee ZCL Thermostat User Interface Configuration	ZCL Thermostat User Interface Configuration	zbee_zcl_hvac.thermo_ui_config
ZigBee ZCL Time	ZCL Time	zbee_zcl_general.time
ZigBee ZCL Touchlink	ZCL Touchlink	zbee_zcl_general.touchlink
ZigBee ZCL Tunneling	ZCL Tunneling	zbee_zcl_se.tun
Zebra Protocol	ZEBRA	zebra
ZigBee Encapsulation Protocol	ZEP	zep
ZigBee Network Layer	ZigBee	zbee_nwk
ZigBee Application Framework	ZigBee APF	zbee_apf
ZigBee Application Support Layer	ZigBee APS	zbee_aps
ZigBee Beacon	ZigBee Beacon	zbee_beacon
ZigBee Green Power Profile	ZigBee Green Power	zbee_nwk_gp
ZigBee IE	ZigBee IE	zbee_ie
ZigBee IP Beacon	ZigBee IP Beacon	zbip_beacon
ZigBee Cluster Library	ZigBee ZCL	zbee_zcl
ZigBee Device Profile	ZigBee ZDP	zbee_zdp
Zipped Inter-ORB Protocol	ZIOP	ziop
Zone Information Protocol	ZIP	zip
ZRTP	ZRTP	zrtp
ZVT Kassenschnittstelle	ZVT	zvt
